datum,t1_vinst,t2_vinst,t3_vinst,t4_vinst,t1_utd,t2_utd,t3_utd,t4_utd,t1_kostn,t2_kostn,t3_kostn,t4_kostn,t1_7,t2_7,t3_7,t4_7,t1_6,t2_6,t3_6,t4_6,t1_5,t2_5,t3_5,t4_5
2016-06-11,1786,1678,1678,1678,2002,1918,1918,1918,216,240,240,240,0,0,0,0,2,2,2,2,24,22,22,22
2016-06-12,1570,1438,1438,1438,2002,1918,1918,1918,432,480,480,480,0,0,0,0,2,2,2,2,24,22,22,22
2016-06-18,17473,17341,17773,17253,18121,18037,18541,18021,648,696,768,768,1,1,1,1,13,13,15,13,77,75,89,74
2016-06-26,31727,31595,32326,31507,32555,32471,33364,32455,828,876,1038,948,2,2,2,2,26,26,29,26,138,136,162,135
2016-07-02,44720,44588,45319,39723,45788,45704,46597,40927,1068,1116,1278,1204,2,2,2,2,29,29,32,28,174,172,198,157
2016-07-07,44640,44456,45271,39591,45996,45860,46805,41083,1356,1404,1534,1492,2,2,2,2,29,29,32,28,182,178,206,163
2016-07-09,44450,44266,45081,39401,46094,45958,46903,41181,1644,1692,1822,1780,2,2,2,2,31,31,34,30,206,200,230,185
2016-07-10,45926,45742,46557,40945,47858,47722,48667,42887,1932,1980,2110,1942,3,3,3,3,43,43,46,40,270,264,294,228
2016-07-16,48844,48660,49475,43916,51019,50883,51828,46020,2175,2223,2353,2104,4,4,4,4,54,54,57,50,320,314,344,269
2016-07-23,49630,48981,49796,44237,52093,51420,52365,46557,2463,2439,2569,2320,4,4,4,4,54,54,57,50,326,317,347,272
2016-07-24,50601,49952,50767,45124,53304,52631,53576,47660,2703,2679,2809,2536,4,4,4,4,55,55,58,51,339,330,360,283
2016-07-26,50460,50804,51619,45976,53379,53699,54644,48728,2919,2895,3025,2752,4,4,4,4,55,57,60,53,342,352,382,305
2016-07-30,50376,50672,51487,45844,53535,53855,54800,48884,3159,3183,3313,3040,4,4,4,4,55,57,60,53,348,358,388,311
2016-08-06,50106,50402,51217,45628,53535,53855,54800,48884,3429,3453,3583,3256,4,4,4,4,55,57,60,53,348,358,388,311
2016-08-07,49818,50114,50929,45412,53535,53855,54800,48884,3717,3741,3871,3472,4,4,4,4,55,57,60,53,348,358,388,311
2016-08-17,52900,53196,54011,48522,56905,57225,58170,52210,4005,4029,4159,3688,5,5,5,5,67,69,72,64,409,419,449,360
2016-08-20,52916,56778,57593,52104,57209,61095,62040,56080,4293,4317,4447,3976,5,5,5,5,67,70,73,65,411,431,461,372
2016-08-27,91781,95643,59300,90969,96290,100176,64017,95161,4509,4533,4717,4192,6,6,5,6,78,81,76,76,462,482,500,423
2016-09-03,91565,95427,59084,90753,96290,100176,64017,95161,4725,4749,4933,4408,6,6,5,6,78,81,76,76,462,482,500,423
2016-09-04,92858,96720,60321,91950,97743,101629,65494,96614,4885,4909,5173,4664,7,7,6,7,90,93,89,88,519,539,571,483
2016-09-10,93367,97229,60830,92459,98468,102354,66219,97339,5101,5125,5389,4880,8,8,7,8,101,104,100,99,572,592,624,536
2016-09-17,101905,105677,69278,100907,107276,111090,74955,106075,5371,5413,5677,5168,9,9,8,9,113,115,111,110,629,645,677,589
2016-09-18,101730,105502,69103,100767,107371,111185,75050,106151,5641,5683,5947,5384,9,9,8,9,118,120,116,114,689,705,737,633
2016-09-24,104966,108738,72339,104058,110850,114664,78529,109604,5884,5926,6190,5546,10,10,9,10,129,131,127,124,739,755,787,674
2016-09-25,106764,110508,74109,105828,112872,116602,80467,111542,6108,6094,6358,5714,10,10,9,10,131,133,129,126,767,781,813,700
2016-10-01,106584,110328,73929,105648,112962,116692,80557,111632,6378,6364,6628,5984,10,10,9,10,134,136,132,129,803,817,849,736
2016-10-08,106296,110040,73641,105360,112962,116692,80557,111632,6666,6652,6916,6272,10,10,9,10,134,136,132,129,803,817,849,736
2016-10-15,107011,110732,74333,106052,113920,117600,81465,112540,6909,6868,7132,6488,10,10,9,10,136,138,134,131,825,837,869,756
2016-10-22,107625,111346,74947,106594,114750,118430,82295,113370,7125,7084,7348,6776,10,10,9,10,138,140,136,133,847,859,891,778
2016-10-23,107337,111058,74659,106306,114750,118430,82295,113370,7413,7372,7636,7064,10,10,9,10,141,143,139,136,883,895,927,814
2016-10-29,107526,111175,74776,106423,115155,118835,82700,113775,7629,7660,7924,7352,11,11,10,11,152,155,151,148,934,955,987,874
2016-11-05,107238,111047,74648,106295,115155,118923,82788,113863,7917,7876,8140,7568,11,11,10,11,152,155,151,148,934,957,989,876
2016-11-06,107514,111131,74732,106379,115647,119169,83034,114109,8133,8038,8302,7730,11,11,10,11,152,155,151,148,938,959,991,878
2016-11-12,108550,112095,75696,107343,116899,120421,84286,115361,8349,8326,8590,8018,11,11,10,11,156,159,155,152,986,1007,1039,926
2016-11-19,111676,115221,78822,110469,120241,123763,87628,118703,8565,8542,8806,8234,12,12,11,12,167,170,166,163,1039,1060,1092,979
2016-11-26,111460,115005,78606,110253,120241,123763,87628,118703,8781,8758,9022,8450,12,12,11,12,167,170,166,163,1039,1060,1092,979
2016-11-27,112130,115675,79276,110923,121127,124649,88514,119589,8997,8974,9238,8666,12,12,11,12,169,172,168,165,1061,1082,1114,1001
2016-12-03,111860,115405,79006,110707,121127,124649,88514,119589,9267,9244,9508,8882,12,12,11,12,169,172,168,165,1070,1091,1123,1010
2016-12-10,112850,116395,79996,111175,122387,125909,89774,120219,9537,9514,9778,9044,12,12,11,12,169,172,168,165,1076,1097,1129,1013
2016-12-17,112634,117076,80677,111856,122459,126878,90743,121188,9825,9802,10066,9332,12,12,11,12,169,175,171,168,1080,1133,1165,1049
2016-12-23,112391,116833,80434,111613,122459,126878,90743,121188,10068,10045,10309,9575,12,12,11,12,169,175,171,168,1080,1133,1165,1049
2016-12-25,113831,117589,81190,112369,124187,127850,91715,122160,10356,10261,10525,9791,12,12,11,12,169,175,171,168,1096,1142,1174,1058
2016-12-26,113843,117601,81134,112327,124361,128024,91947,122334,10518,10423,10813,10007,12,12,11,12,172,178,175,171,1129,1175,1226,1091
2016-12-27,114968,118726,82259,113077,125729,129392,93315,123246,10761,10666,11056,10169,12,12,11,12,172,178,175,171,1138,1184,1235,1097
2016-12-28,123490,127248,90781,112971,134539,138202,102125,123428,11049,10954,11344,10457,13,13,12,12,184,190,187,173,1198,1244,1295,1119
2016-12-29,123330,126960,90493,112683,134667,138202,102125,123428,11337,11242,11632,10745,13,13,12,12,184,190,187,173,1202,1244,1295,1119
2016-12-30,127184,130814,94347,116537,138809,142344,106267,127570,11625,11530,11920,11033,13,13,12,12,186,192,189,175,1226,1268,1319,1143
2016-12-31,127988,131141,94674,116864,139901,142863,106786,128089,11913,11722,12112,11225,13,13,12,12,188,193,190,176,1250,1279,1330,1154
2017-01-07,130451,133604,97287,119327,142580,145542,109669,130768,12129,11938,12382,11441,13,13,12,12,191,196,193,179,1283,1312,1369,1187
2017-01-14,131621,134774,98457,120416,144020,146982,111109,132145,12399,12208,12652,11729,13,13,12,12,194,199,196,182,1319,1348,1405,1220
2017-01-21,132287,135440,99123,121082,144929,147891,112018,133054,12642,12451,12895,11972,13,13,12,12,194,199,196,182,1328,1357,1414,1229
2017-01-28,144663,147528,111211,133170,157521,160141,124268,145304,12858,12613,13057,12134,14,14,13,13,205,209,206,192,1377,1398,1455,1270
2017-01-29,144393,147492,111175,133134,157521,160393,124520,145556,13128,12901,13345,12422,14,14,13,13,205,209,206,192,1377,1402,1459,1274
2017-02-04,161794,164507,128190,150149,175210,177696,141823,162859,13416,13189,13633,12710,15,15,14,14,217,220,217,203,1435,1453,1510,1325
2017-02-11,162194,164907,128590,150549,175898,178384,142511,163547,13704,13477,13921,12998,15,15,14,14,218,221,218,204,1448,1466,1523,1338
2017-02-18,161954,164667,128350,150309,175898,178384,142511,163547,13944,13717,14161,13238,15,15,14,14,218,221,218,204,1448,1466,1523,1338
2017-02-25,161711,164424,128080,150066,175898,178384,142511,163547,14187,13960,14431,13481,15,15,14,14,218,221,218,204,1457,1475,1535,1347
2017-02-26,207263,186292,149948,171934,221706,200540,164667,185703,14443,14248,14719,13769,15,15,14,14,222,223,220,206,1505,1497,1557,1369
2017-03-04,207284,186198,149854,171840,221889,200662,164789,185825,14605,14464,14935,13985,15,15,14,14,222,223,220,206,1508,1499,1559,1371
2017-03-11,207149,186063,149719,171705,222042,200815,164942,185978,14893,14752,15223,14273,15,15,14,14,225,226,223,209,1544,1535,1595,1407
2017-03-18,208747,187661,151317,173303,223883,202656,166783,187819,15136,14995,15466,14516,16,16,15,15,236,237,234,220,1598,1589,1649,1461
2017-03-25,209047,187445,151101,173087,224471,202656,166783,187819,15424,15211,15682,14732,16,16,15,15,236,237,234,220,1604,1589,1649,1461
2017-03-26,210058,188017,151673,173659,225725,203444,167571,188607,15667,15427,15898,14948,16,16,15,15,239,239,236,222,1637,1609,1669,1481
2017-04-01,209842,187801,151385,173371,225725,203444,167571,188607,15883,15643,16186,15236,16,16,15,15,239,239,236,222,1637,1609,1669,1481
2017-04-08,209554,187513,151097,173155,225725,203444,167571,188607,16171,15931,16474,15452,16,16,15,15,239,239,236,222,1637,1609,1669,1481
2017-04-14,210382,188341,151925,173653,226796,204515,168642,189321,16414,16174,16717,15668,16,16,15,15,239,239,236,222,1646,1618,1678,1487
2017-04-16,210972,188931,152515,173840,227656,205375,169502,189751,16684,16444,16987,15911,16,16,15,15,239,239,236,222,1650,1622,1682,1489
2017-04-22,212452,190411,153995,174872,229436,207155,171282,191039,16984,16744,17287,16167,16,16,15,15,244,244,241,226,1715,1687,1747,1533
2017-04-29,212212,190171,153755,174632,229436,207155,171282,191039,17224,16984,17527,16407,16,16,15,15,244,244,241,226,1715,1687,1747,1533
2017-05-01,212034,190559,154143,175020,229498,207735,171862,191619,17464,17176,17719,16599,16,16,15,15,244,245,242,227,1717,1698,1758,1544
2017-05-06,211818,190343,153927,174804,229498,207735,171862,191619,17680,17392,17935,16815,16,16,15,15,244,245,242,227,1717,1698,1758,1544
2017-05-07,211863,190689,162865,175150,229813,208297,181070,192181,17950,17608,18205,17031,16,16,16,15,245,247,254,229,1729,1718,1815,1564
2017-05-13,211651,190587,162763,175048,229889,208411,181184,192295,18238,17824,18421,17247,16,16,16,15,245,247,254,229,1733,1724,1821,1570
2017-05-14,211435,190299,162475,174760,229889,208411,181184,192295,18454,18112,18709,17535,16,16,16,15,245,247,254,229,1733,1724,1821,1570
2017-05-20,211387,190251,162427,174632,230129,208651,181424,192455,18742,18400,18997,17823,16,16,16,15,245,247,254,229,1745,1736,1833,1578
2017-05-27,212218,191082,163258,175078,231230,209752,182525,193189,19012,18670,19267,18111,16,16,16,15,245,247,254,229,1748,1739,1836,1580
2017-05-28,212018,193261,165437,177257,231273,212147,184920,195584,19255,18886,19483,18327,16,17,17,16,246,257,264,239,1759,1783,1880,1624
2017-06-03,212522,193765,165941,177761,231993,212867,185640,196304,19471,19102,19699,18543,16,17,17,16,246,257,264,239,1763,1787,1884,1628
2017-06-10,213752,194461,166637,178457,233511,213779,186552,197216,19759,19318,19915,18759,16,17,17,16,249,259,266,241,1802,1809,1906,1650
2017-06-11,213698,194407,166583,178403,233727,213995,186768,197432,20029,19588,20185,19029,16,17,17,16,249,259,266,241,1808,1815,1912,1656
2017-06-17,213428,194137,166503,178187,233727,213995,186928,197432,20299,19858,20425,19245,16,17,17,16,249,259,268,241,1812,1819,1938,1658
2017-06-25,213800,194509,166875,178339,234387,214655,187588,197872,20587,20146,20713,19533,16,17,17,16,249,259,268,241,1818,1825,1944,1662
2017-07-01,214022,194731,167097,178561,234825,215093,188026,198310,20803,20362,20929,19749,16,17,17,16,249,259,268,241,1824,1831,1950,1668
2017-07-06,214158,194867,167233,178697,235177,215445,188378,198662,21019,20578,21145,19965,16,17,17,16,253,263,272,245,1872,1879,1998,1712
2017-07-08,215205,195914,168805,179744,236440,216708,190238,199925,21235,20794,21433,20181,16,17,17,16,256,266,276,248,1905,1912,2050,1745
2017-07-09,215023,195732,168663,179562,236498,216766,190296,199983,21475,21034,21633,20421,16,17,17,16,257,267,277,249,1918,1925,2064,1758
2017-07-15,214735,195444,168375,179274,236498,216766,190296,199983,21763,21322,21921,20709,16,17,17,16,257,267,277,249,1918,1925,2064,1758
2017-07-22,215203,195912,168843,179478,237236,217504,191034,200475,22033,21592,22191,20997,16,17,17,16,257,267,277,249,1927,1934,2073,1764
2017-07-23,214987,195696,168627,179262,237236,217504,191034,200475,22249,21808,22407,21213,16,17,17,16,257,267,277,249,1927,1934,2073,1764
2017-07-25,214852,196630,169561,180196,237317,218654,192184,201625,22465,22024,22623,21429,16,17,17,16,257,269,279,251,1930,1956,2095,1786
2017-07-29,215341,196902,169833,180468,238049,219142,192672,202113,22708,22240,22839,21645,16,17,17,16,257,269,279,251,1936,1960,2099,1790
2017-08-05,217807,199296,172227,182862,240731,221824,195354,204795,22924,22528,23127,21933,16,17,17,16,259,271,281,253,1958,1982,2121,1812
2017-08-13,217519,199008,171939,182574,240731,221824,195354,204795,23212,22816,23415,22221,16,17,17,16,259,271,281,253,1958,1982,2121,1812
2017-08-16,217375,198864,171813,182502,240875,221968,195498,204939,23500,23104,23685,22437,16,17,17,16,262,274,284,256,1994,2018,2160,1845
2017-08-19,217135,198624,171573,182262,240875,221968,195498,204939,23740,23344,23925,22677,16,17,17,16,262,274,284,256,1994,2018,2160,1845
2017-08-23,220783,202272,175221,185910,244811,225904,199434,208875,24028,23632,24213,22965,17,18,18,17,275,287,297,269,2061,2085,2227,1912
2017-08-24,220567,202056,175005,185694,244811,225904,199434,208875,24244,23848,24429,23181,17,18,18,17,275,287,297,269,2061,2085,2227,1912
2017-08-25,220279,201768,174717,185406,244811,225904,199434,208875,24532,24136,24717,23469,17,18,18,17,275,287,297,269,2061,2085,2227,1912
2017-08-26,220009,201498,174447,185166,244811,225904,199434,208875,24802,24406,24987,23709,17,18,18,17,275,287,297,269,2061,2085,2227,1912
2017-08-27,220981,201386,174335,185054,246071,226008,199538,208979,25090,24622,25203,23925,17,18,18,17,277,287,297,269,2085,2089,2231,1916
2017-09-02,220789,201098,174047,184766,246071,226008,199538,208979,25282,24910,25491,24213,17,18,18,17,277,287,297,269,2085,2089,2231,1916
2017-09-03,224559,204868,177817,188600,250097,230034,203564,213005,25538,25166,25747,24405,18,19,19,18,289,299,309,281,2142,2146,2288,1972
2017-09-09,225377,205578,178527,189310,251203,231032,204562,214003,25826,25454,26035,24693,18,19,19,18,291,301,311,283,2168,2168,2310,1994
2017-09-10,227960,208161,181110,191893,254029,233858,207388,216829,26069,25697,26278,24936,18,19,19,18,291,301,311,283,2174,2174,2316,2000
2017-09-16,227672,207873,180822,191605,254029,233858,207388,216829,26357,25985,26566,25224,18,19,19,18,291,301,311,283,2174,2174,2316,2000
2017-09-23,236848,217049,189998,200616,263493,243322,216852,226056,26645,26273,26854,25440,19,20,20,19,303,313,323,294,2234,2234,2376,2051
2017-09-30,236666,216867,189816,200434,263551,243380,216910,226114,26885,26513,27094,25680,19,20,20,19,305,315,325,296,2258,2258,2400,2075
2017-10-01,236922,217123,190072,200690,264063,243892,217422,226626,27141,26769,27350,25936,19,20,20,19,305,315,325,296,2266,2266,2408,2083
2017-10-07,237242,217235,190184,200802,264671,244196,217726,226930,27429,26961,27542,26128,19,20,20,19,305,315,325,296,2270,2268,2410,2085
2017-10-14,238442,218435,191384,202002,266159,245684,219214,228418,27717,27249,27830,26416,20,21,21,20,318,328,338,309,2335,2333,2475,2150
2017-10-21,238424,218417,191366,207462,266411,245936,219466,234094,27987,27519,28100,26632,20,21,21,20,318,328,338,313,2339,2337,2479,2194
2017-10-28,240200,220193,193142,209238,268403,247928,221458,236086,28203,27735,28316,26848,20,21,21,20,320,330,340,315,2361,2359,2501,2216
2017-10-29,240733,220726,193690,209813,269224,248749,222294,236877,28491,28023,28604,27064,21,22,22,21,332,342,353,325,2422,2420,2568,2260
2017-11-04,297872,276961,249925,266048,326579,305200,278745,293328,28707,28239,28820,27280,22,23,23,22,343,352,363,335,2473,2463,2611,2303
2017-11-11,298097,276874,249838,265961,327047,305356,278901,293484,28950,28482,29063,27523,22,23,23,22,343,352,363,335,2479,2465,2613,2305
2017-11-12,298382,276658,249622,265745,327575,305356,278901,293484,29193,28698,29279,27739,22,23,23,22,343,352,363,335,2485,2465,2613,2305
2017-11-18,298342,276510,249474,265597,327791,305464,279009,293592,29449,28954,29535,27995,22,23,23,22,343,352,363,335,2489,2467,2615,2307
2017-11-25,298219,276284,249248,265371,327884,305526,279071,293654,29665,29242,29823,28283,22,23,23,22,343,352,363,335,2492,2469,2617,2309
2017-11-26,304115,282180,255144,271162,334050,311692,285237,299733,29935,29512,30093,28571,23,24,24,23,355,364,375,346,2551,2528,2676,2361
2017-12-02,304151,282126,255090,271108,334302,311881,285426,299922,30151,29755,30336,28814,23,24,24,23,355,364,375,346,2563,2537,2685,2370
2017-12-09,304195,282170,267373,271248,334634,312213,297949,300254,30439,30043,30576,29006,23,24,25,23,359,368,388,350,2611,2585,2753,2414
2017-12-16,304565,282540,267743,271618,335292,312871,298607,300912,30727,30331,30864,29294,23,24,25,23,361,370,390,352,2635,2609,2777,2438
2017-12-23,304765,282740,267943,271818,335780,313359,299095,301400,31015,30619,31152,29582,23,24,25,23,361,370,390,352,2643,2617,2785,2446
2017-12-25,305197,282932,268135,272010,336500,313839,299575,301880,31303,30907,31440,29870,23,24,25,23,361,370,390,352,2649,2621,2789,2450
2017-12-26,337812,314432,299635,303510,369358,345555,331291,333596,31546,31123,31656,30086,23,24,25,23,363,372,392,354,2671,2641,2809,2470
2017-12-27,337650,314270,299347,303294,369358,345555,331291,333596,31708,31285,31944,30302,23,24,25,23,363,372,392,354,2683,2653,2821,2482
2017-12-28,338747,315443,300520,304467,370743,346890,332626,334931,31996,31447,32106,30464,24,25,26,24,375,382,402,364,2742,2695,2863,2524
2017-12-29,338459,315155,300232,304179,370743,346890,332626,334931,32284,31735,32394,30752,24,25,26,24,375,382,402,364,2742,2695,2863,2524
2017-12-30,338459,315155,300232,304179,370959,347106,332842,335147,32500,31951,32610,30968,24,25,26,24,375,382,402,364,2748,2701,2869,2530
2017-12-31,338216,314939,300016,303963,370959,347106,332842,335147,32743,32167,32826,31184,24,25,26,24,375,382,402,364,2748,2701,2869,2530
2018-01-06,337928,314651,299728,303675,370959,347106,332842,335147,33031,32455,33114,31472,24,25,26,24,375,382,402,364,2748,2701,2869,2530
2018-01-13,341735,318386,303463,307410,374982,351129,336865,339170,33247,32743,33402,31760,25,26,27,25,386,393,413,375,2800,2754,2922,2583
2018-01-20,341501,318152,303229,307284,375048,351195,336931,339236,33547,33043,33702,31952,25,26,27,25,389,396,416,378,2839,2793,2961,2616
2018-01-27,344896,321547,306624,310679,378686,354833,340569,342874,33790,33286,33945,32195,26,27,28,26,400,407,427,389,2891,2845,3013,2668
2018-01-28,344608,321331,306408,310463,378686,354833,340569,342874,34078,33502,34161,32411,26,27,28,26,400,407,427,389,2895,2849,3017,2672
2018-02-03,344320,321043,306120,310175,378686,354833,340569,342874,34366,33790,34449,32699,26,27,28,26,400,407,427,389,2911,2865,3033,2688
2018-02-10,344156,320879,305956,310011,378810,354957,340693,342998,34654,34078,34737,32987,26,27,28,26,402,409,429,391,2935,2889,3061,2712
2018-02-17,344276,320999,306076,309963,379146,355293,341029,343166,34870,34294,34953,33203,26,27,28,26,402,409,429,391,2943,2897,3069,2716
2018-02-24,345708,321643,306720,310607,380866,356153,341889,344026,35158,34510,35169,33419,26,27,28,26,402,409,429,391,2951,2901,3073,2720
2018-02-25,345771,321403,306480,310367,381229,356153,341889,344026,35458,34750,35409,33659,26,27,28,26,402,409,429,391,2952,2901,3073,2720
2018-03-03,345483,321187,306264,310151,381229,356153,341889,344026,35746,34966,35625,33875,26,27,28,26,402,409,429,391,2952,2901,3073,2720
2018-03-10,345555,321259,306336,310151,381517,356441,342177,344314,35962,35182,35841,34163,26,27,28,26,405,412,432,394,2985,2934,3106,2753
2018-03-17,345487,321191,306268,310083,381665,356589,342325,344462,36178,35398,36057,34379,26,27,28,26,409,416,436,398,3029,2978,3150,2797
2018-03-24,345442,321161,306238,310053,381863,356721,342457,344594,36421,35560,36219,34541,26,27,28,26,409,416,436,398,3038,2984,3156,2803
2018-03-29,345800,321519,306596,310363,382461,357319,343055,345192,36661,35800,36459,34829,27,28,29,27,422,429,449,411,3107,3053,3225,2870
2018-03-30,347550,323269,308346,312021,384499,359357,345093,347138,36949,36088,36747,35117,27,28,29,27,424,431,451,413,3131,3077,3249,2892
2018-03-31,349514,325233,310310,313985,386719,361577,347313,349358,37205,36344,37003,35373,27,28,29,27,428,435,455,417,3179,3125,3297,2940
2018-04-01,351949,327668,312767,316348,389370,364228,350010,352009,37421,36560,37243,35661,28,29,30,28,439,446,468,428,3231,3177,3362,2993
2018-04-07,353306,327488,312587,316168,390970,364264,350046,352045,37664,36776,37459,35877,29,29,30,28,450,448,470,430,3283,3197,3382,3013
2018-04-14,353146,327668,312767,316348,390970,364684,350466,352465,37824,37016,37699,36117,29,29,30,28,450,448,470,430,3283,3203,3388,3019
2018-04-21,353006,327528,312627,316132,391118,364832,350614,352465,38112,37304,37987,36333,29,29,30,28,450,448,470,430,3287,3207,3392,3019
2018-04-28,353858,328380,313479,316984,392186,365900,351682,353533,38328,37520,38203,36549,29,29,30,28,453,451,473,433,3320,3240,3425,3052
2018-05-01,354677,329226,314325,317830,393248,366962,352744,354595,38571,37736,38419,36765,29,29,30,28,453,451,473,433,3329,3249,3434,3061
2018-05-05,356823,331254,316353,319858,395682,369278,355060,356911,38859,38024,38707,37053,29,29,30,28,455,453,475,435,3353,3271,3456,3083
2018-05-06,356579,331010,316149,319740,395726,369322,355126,356955,39147,38312,38977,37215,29,29,30,28,457,455,478,437,3377,3295,3495,3103
2018-05-12,357314,331745,316884,320475,396731,370327,356131,357960,39417,38582,39247,37485,29,29,30,28,460,458,481,440,3416,3334,3534,3142
2018-05-13,357206,331637,316776,320349,396911,370507,356311,358050,39705,38870,39535,37701,29,29,30,28,460,458,481,440,3428,3346,3546,3148
2018-05-19,358311,332742,317881,321470,398316,371912,357716,359411,40005,39170,39835,37941,30,30,31,29,474,472,495,452,3507,3425,3629,3208
2018-05-26,360591,335022,320161,322438,400812,374408,360212,360595,40221,39386,40051,38157,30,30,31,29,478,476,499,454,3551,3469,3673,3228
2018-05-27,360321,334752,320041,322168,400812,374408,360332,360595,40491,39656,40291,38427,30,30,31,29,478,476,501,454,3557,3472,3697,3231
2018-06-02,360078,334768,320057,322184,400812,374586,360510,360773,40734,39818,40453,38589,30,30,31,29,478,476,501,454,3557,3474,3699,3233
2018-06-09,359790,334480,319769,321896,400812,374586,360510,360773,41022,40106,40741,38877,30,30,31,29,478,476,501,454,3565,3482,3707,3237
2018-06-10,359592,334282,319571,321680,400884,374658,360582,360845,41292,40376,41011,39165,30,30,31,29,481,479,504,457,3604,3521,3746,3273
2018-06-16,359356,334994,320283,322392,400936,375658,361582,361845,41580,40664,41299,39453,30,30,31,29,481,481,506,459,3606,3543,3768,3295
2018-06-24,359714,335352,320641,322770,401510,376232,362156,362385,41796,40880,41515,39615,30,30,31,29,483,483,508,461,3628,3565,3790,3315
2018-06-30,365002,337714,323003,325132,407086,378882,364806,365035,42084,41168,41803,39903,30,30,31,29,487,485,510,463,3676,3587,3812,3337
2018-07-05,364734,337446,322735,325965,407106,378902,364826,366156,42372,41456,42091,40191,30,30,31,30,488,486,511,474,3688,3599,3825,3389
2018-07-07,364570,337282,322571,325801,407230,379026,364950,366280,42660,41744,42379,40479,30,30,31,30,488,486,511,474,3692,3603,3829,3393
2018-07-08,364360,337072,325002,325591,407308,379104,367681,366358,42948,42032,42679,40767,30,30,32,30,490,488,525,476,3716,3627,3916,3415
2018-07-14,364072,336784,324714,325375,407308,379104,367681,366358,43236,42320,42967,40983,30,30,32,30,490,488,525,476,3716,3627,3916,3415
2018-07-21,365740,338452,326382,327043,409264,381060,369637,368314,43524,42608,43255,41271,30,30,32,30,490,488,525,476,3720,3631,3920,3419
2018-07-22,365924,338636,326566,327227,409736,381532,370109,368786,43812,42896,43543,41559,30,30,32,30,490,488,525,476,3728,3639,3928,3427
2018-07-28,377236,349948,337878,327083,421210,393006,381583,368858,43974,43058,43705,41775,31,31,33,30,501,499,536,476,3776,3687,3976,3431
2018-07-31,377016,349728,337658,326867,421278,393074,381651,368858,44262,43346,43993,41991,31,31,33,30,501,499,536,476,3778,3689,3978,3431
2018-08-04,376773,349566,337496,326705,421278,393074,381651,368858,44505,43508,44155,42153,31,31,33,30,501,499,536,476,3778,3689,3978,3431
2018-08-11,376613,349406,337336,326465,421278,393074,381651,368858,44665,43668,44315,42393,31,31,33,30,501,499,536,476,3778,3689,3978,3431
2018-08-12,376325,349118,337048,326177,421278,393074,381651,368858,44953,43956,44603,42681,31,31,33,30,501,499,536,476,3784,3695,3984,3437
2018-08-14,377821,350518,338448,327577,422966,394762,383339,370546,45145,44244,44891,42969,31,31,33,30,502,500,537,477,3796,3707,3996,3449
2018-08-18,378277,350674,338604,327733,423710,395134,383711,370918,45433,44460,45107,43185,31,31,33,30,502,500,537,477,3808,3713,4002,3455
2018-08-22,378007,350386,338316,327445,423710,395134,383711,370918,45703,44748,45395,43473,31,31,33,30,502,500,537,477,3808,3713,4002,3455
2018-08-23,377971,350350,338124,327409,423944,395368,383789,371152,45973,45018,45665,43743,31,31,33,30,502,500,537,477,3817,3722,4005,3464
2018-08-24,377785,350164,337938,327223,423974,395398,383819,371182,46189,45234,45881,43959,31,31,33,30,504,502,539,479,3839,3744,4027,3484
2018-08-25,378659,351038,338812,328119,425136,396560,384981,372240,46477,45522,46169,44121,31,31,33,30,506,504,541,481,3863,3768,4051,3504
2018-08-26,378475,350854,338628,327973,425168,396592,385013,372256,46693,45738,46385,44283,31,31,33,30,508,506,543,482,3885,3790,4073,3514
2018-09-01,410337,382716,370490,329515,457300,428724,417145,373960,46963,46008,46655,44445,32,32,34,30,520,518,555,485,3942,3847,4130,3544
2018-09-02,410233,382612,370440,329411,457466,428890,417311,374126,47233,46278,46871,44715,32,32,34,30,522,520,557,487,3966,3871,4156,3568
2018-09-08,410055,383666,371494,330465,457576,430160,418581,375396,47521,46494,47087,44931,32,32,34,30,522,521,558,488,3968,3882,4167,3579
2018-09-09,410159,383770,371598,330489,457968,430552,418973,375690,47809,46782,47375,45201,32,32,34,30,522,521,558,488,3972,3886,4171,3582
2018-09-15,414075,387686,375514,334405,462124,434708,423129,379846,48049,47022,47615,45441,33,33,35,31,534,533,570,500,4032,3946,4231,3642
2018-09-16,413775,387386,375214,334165,462124,434708,423129,379846,48349,47322,47915,45681,33,33,35,31,534,533,570,500,4032,3946,4231,3642
2018-09-22,413559,387170,375322,333949,462124,434708,423477,379846,48565,47538,48155,45897,33,33,35,31,534,533,573,500,4038,3952,4270,3648
2018-09-29,415886,389497,377649,336269,464721,437305,426074,382406,48835,47808,48425,46137,34,34,36,32,546,545,585,511,4095,4009,4327,3697
2018-09-30,415661,389272,377424,335969,464721,437305,426074,382406,49060,48033,48650,46437,34,34,36,32,546,545,585,511,4095,4009,4327,3697
2018-10-06,416565,390176,378318,336873,465865,438449,427238,383550,49300,48273,48920,46677,35,35,37,33,558,557,598,523,4152,4066,4393,3754
2018-10-13,416385,389996,378225,336585,465865,438449,427445,383550,49480,48453,49220,46965,35,35,37,33,558,557,601,523,4155,4069,4435,3757
2018-10-20,416820,390203,378432,336792,466570,438872,427868,383973,49750,48669,49436,47181,35,35,37,33,558,557,601,523,4170,4078,4444,3766
2018-10-27,416810,390193,378395,336863,466803,439105,428101,384206,49993,48912,49706,47343,36,36,38,34,569,568,614,533,4222,4130,4510,3809
2018-10-28,416895,390332,378534,337002,467158,439460,428456,384561,50263,49128,49922,47559,37,37,39,35,581,578,624,543,4281,4173,4553,3852
2018-11-03,416625,390092,378294,336762,467158,439460,428456,384561,50533,49368,50162,47799,37,37,39,35,581,578,624,543,4281,4173,4553,3852
2018-11-10,416651,390118,378320,336788,467454,439756,428752,384857,50803,49638,50432,48069,37,37,39,35,581,578,624,543,4285,4177,4557,3856
2018-11-11,416471,389884,378086,336554,467562,439810,428806,384911,51091,49926,50720,48357,37,37,39,35,581,578,624,543,4289,4179,4559,3858
2018-11-17,416255,389596,377798,336266,467562,439810,428806,384911,51307,50214,51008,48645,37,37,39,35,581,578,624,543,4289,4179,4559,3858
2018-11-24,415955,389296,377498,335978,467562,439810,428806,384911,51607,50514,51308,48933,37,37,39,35,581,578,624,543,4289,4179,4559,3858
2018-11-25,416063,389404,377606,336167,467913,440161,429157,385262,51850,50757,51551,49095,38,38,40,36,592,589,635,553,4339,4229,4609,3901
2018-12-01,416042,389383,377585,336173,468135,440383,429379,385484,52093,51000,51794,49311,38,38,40,36,595,592,638,556,4372,4262,4642,3931
2018-12-08,416105,389446,377669,336071,468414,440662,429751,385670,52309,51216,52082,49599,38,38,40,36,598,595,642,558,4408,4298,4694,3955
2018-12-15,416102,389443,377666,336068,468681,440929,430018,385937,52579,51486,52352,49869,38,38,40,36,601,598,645,561,4444,4334,4730,3991
2018-12-22,416144,389485,377708,336110,468885,441133,430222,386141,52741,51648,52514,50031,38,38,40,36,601,598,645,561,4447,4337,4733,3994
2018-12-23,415928,392359,380582,338984,468885,444295,433384,389303,52957,51936,52802,50319,38,38,40,36,601,598,645,561,4447,4343,4739,4000
2018-12-25,415658,392071,380294,338696,468885,444295,433384,389303,53227,52224,53090,50607,38,38,40,36,601,598,645,561,4447,4343,4739,4000
2018-12-26,415370,391783,380006,338408,468885,444295,433384,389303,53515,52512,53378,50895,38,38,40,36,601,598,645,561,4447,4343,4739,4000
2018-12-27,415082,391495,379718,338120,468885,444295,433384,389303,53803,52800,53666,51183,38,38,40,36,601,598,645,561,4447,4343,4739,4000
2018-12-28,415718,392131,380758,338448,469809,445219,434680,389919,54091,53088,53922,51471,38,38,40,36,604,601,649,563,4483,4379,4791,4024
2018-12-29,416691,393104,381731,339415,471052,446462,435923,391102,54361,53358,54192,51687,38,38,40,36,605,602,650,564,4495,4391,4803,4035
2018-12-30,416435,392848,381491,339159,471052,446462,435923,391102,54617,53614,54432,51943,38,38,40,36,605,602,650,564,4495,4391,4803,4035
2018-12-31,417001,394124,382767,340435,471834,448026,437487,392666,54833,53902,54720,52231,38,38,40,36,605,602,650,564,4497,4395,4807,4039
2019-01-05,417685,394853,383496,341164,472806,448998,438459,393638,55121,54145,54963,52474,38,38,40,36,605,602,650,564,4506,4404,4816,4048
2019-01-12,418251,395041,383684,341352,473660,449402,438863,394042,55409,54361,55179,52690,38,38,40,36,607,603,651,565,4530,4415,4827,4059
2019-01-19,427173,395671,384314,341982,482825,450248,439709,394888,55652,54577,55395,52906,38,38,40,36,610,603,651,565,4563,4421,4833,4065
2019-01-26,426957,395455,384098,341766,482825,450248,439709,394888,55868,54793,55611,53122,38,38,40,36,610,603,651,565,4563,4421,4833,4065
2019-01-27,427145,395881,384524,342192,483301,450962,440423,395602,56156,55081,55899,53410,38,38,40,36,610,603,651,565,4567,4427,4839,4071
2019-02-02,426857,396787,385430,343098,483301,452156,441617,396796,56444,55369,56187,53698,38,38,40,36,610,603,651,565,4567,4433,4845,4077
2019-02-09,426569,396499,385142,342810,483301,452156,441617,396796,56732,55657,56475,53986,38,38,40,36,610,603,651,565,4567,4433,4845,4077
2019-02-16,427754,397171,385814,343482,484702,453044,442505,397684,56948,55873,56691,54202,38,38,40,36,613,605,653,567,4600,4453,4865,4097
2019-02-23,427466,396955,385598,343266,484702,453044,442505,397684,57236,56089,56907,54418,38,38,40,36,613,605,653,567,4600,4453,4865,4097
2019-03-02,427816,397163,385806,343474,485322,453540,443001,398180,57506,56377,57195,54706,38,38,40,36,613,605,653,567,4610,4461,4873,4105
2019-03-03,441372,410383,399026,356694,499166,466976,456437,411616,57794,56593,57411,54922,39,39,41,37,625,616,664,578,4674,4514,4926,4158
2019-03-09,444997,414008,402651,360319,503061,470871,460332,415511,58064,56863,57681,55192,40,40,42,38,637,628,676,590,4733,4573,4985,4217
2019-03-16,446071,414410,403053,360721,504405,471543,461004,416183,58334,57133,57951,55462,40,40,42,38,637,628,676,590,4745,4579,4991,4223
2019-03-23,480928,449267,437910,395578,539550,506688,496149,451328,58622,57421,58239,55750,41,41,43,39,650,641,689,603,4818,4652,5064,4296
2019-03-30,481389,449728,438371,396041,540299,507437,496898,452007,58910,57709,58527,55966,41,41,43,39,651,642,690,604,4831,4665,5077,4307
2019-03-31,481231,449570,438213,396254,540321,507459,496920,452436,59090,57889,58707,56182,41,41,43,39,651,642,690,605,4832,4666,5078,4318
2019-04-06,481132,449471,438114,396155,540438,507576,497037,452553,59306,58105,58923,56398,41,41,43,39,651,642,690,605,4835,4669,5081,4321
2019-04-13,480943,449201,437844,395885,540519,507576,497037,452553,59576,58375,59193,56668,41,41,43,39,651,642,690,605,4838,4669,5081,4321
2019-04-18,480700,448958,437601,395642,540519,507576,497037,452553,59819,58618,59436,56911,41,41,43,39,654,645,693,608,4871,4702,5114,4354
2019-04-19,480604,448862,437681,395546,540711,507768,497357,452745,60107,58906,59676,57199,41,41,43,39,654,645,693,608,4877,4708,5124,4360
2019-04-20,480502,448698,437517,395382,540897,507892,497481,452869,60395,59194,59964,57487,41,41,43,39,657,647,695,610,4916,4732,5148,4384
2019-04-21,480214,448656,437475,395340,540897,508138,497727,453115,60683,59482,60252,57775,41,41,43,39,657,647,695,610,4916,4738,5154,4390
2019-04-27,479944,448368,437187,395052,540897,508138,497727,453115,60953,59770,60540,58063,41,41,43,39,657,647,695,610,4931,4746,5162,4398
2019-05-01,484293,452717,441536,399401,545516,512757,502346,457734,61223,60040,60810,58333,42,42,44,40,669,659,707,622,4992,4807,5223,4459
2019-05-04,494227,462651,451470,409263,555738,522979,512568,467812,61511,60328,61098,58549,43,43,45,41,681,671,719,632,5059,4874,5290,4502
2019-05-11,494651,462791,451610,409403,556450,523335,512924,468168,61799,60544,61314,58765,43,43,45,41,681,671,719,632,5067,4878,5294,4506
2019-05-12,495209,462601,451420,409213,557278,523415,513004,468248,62069,60814,61584,59035,43,43,45,41,683,671,719,632,5091,4882,5298,4510
2019-05-18,495115,464233,453052,410845,557454,525317,514906,470150,62339,61084,61854,59305,43,43,45,41,683,672,720,633,5093,4894,5310,4522
2019-05-25,494875,463993,452812,410605,557454,525317,514906,470150,62579,61324,62094,59545,43,43,45,41,683,672,720,633,5093,4894,5310,4522
2019-05-26,494632,463777,452596,410389,557454,525317,514906,470150,62822,61540,62310,59761,43,43,45,41,683,672,720,633,5093,4894,5310,4522
2019-06-01,494716,463861,452680,410473,557754,525617,515206,470450,63038,61756,62526,59977,43,43,45,41,683,672,720,633,5099,4900,5316,4528
2019-06-08,494428,463645,452464,410257,557754,525617,515206,470450,63326,61972,62742,60193,43,43,45,41,683,672,720,633,5099,4900,5316,4528
2019-06-09,494680,463969,452788,410581,558294,526157,515746,470990,63614,62188,62958,60409,43,43,45,41,683,672,720,633,5111,4912,5328,4540
2019-06-15,495005,464763,453582,411375,558835,527239,516828,472072,63830,62476,63246,60697,43,43,45,41,684,674,722,635,5122,4934,5350,4562
2019-06-23,494735,464475,453294,411087,558835,527239,516828,472072,64100,62764,63534,60985,43,43,45,41,684,674,722,635,5122,4934,5350,4562
2019-06-29,496040,465752,454571,412364,560428,528804,518393,473637,64388,63052,63822,61273,44,44,46,42,696,685,733,646,5180,4986,5402,4614
2019-07-04,495770,465464,454283,412076,560428,528804,518393,473637,64658,63340,64110,61561,44,44,46,42,696,685,733,646,5180,4986,5402,4614
2019-07-06,495530,465224,454043,411836,560428,528804,518393,473637,64898,63580,64350,61801,44,44,46,42,696,685,733,646,5180,4986,5402,4614
2019-07-07,495706,465400,454274,412012,560892,529268,518880,474101,65186,63868,64606,62089,44,44,46,42,697,686,734,647,5192,4998,5415,4626
2019-07-13,495418,465184,454058,411796,560892,529268,518880,474101,65474,64084,64822,62305,44,44,46,42,697,686,734,647,5192,4998,5415,4626
2019-07-20,495262,465028,453902,411640,560952,529328,518940,474161,65690,64300,65038,62521,44,44,46,42,697,686,734,647,5194,5000,5417,4628
2019-07-21,495167,464843,453717,411455,561037,529413,519025,474246,65870,64570,65308,62791,44,44,46,42,697,686,734,647,5199,5005,5422,4633
2019-07-27,495878,465482,454356,412094,561964,530340,519952,475173,66086,64858,65596,63079,45,45,47,43,708,697,745,658,5254,5058,5475,4686
2019-07-30,496067,465671,454068,412283,562315,530691,519952,475524,66248,65020,65884,63241,45,45,47,43,711,700,745,661,5287,5091,5478,4719
2019-08-03,502449,472053,460478,418593,568913,537289,526605,482122,66464,65236,66127,63529,46,46,48,44,723,712,758,673,5343,5147,5546,4775
2019-08-10,502233,471837,460262,418305,568913,537289,526605,482122,66680,65452,66343,63817,46,46,48,44,725,714,760,675,5365,5169,5568,4797
2019-08-11,502487,477936,466361,424404,569383,543604,532920,488437,66896,65668,66559,64033,46,46,48,44,725,715,761,676,5367,5180,5579,4808
2019-08-14,502777,478298,466723,424766,569961,544182,533498,489015,67184,65884,66775,64249,47,47,49,45,737,726,772,687,5426,5229,5628,4857
2019-08-17,502591,478112,466537,424580,570063,544284,533600,489117,67472,66172,67063,64537,47,47,49,45,740,729,775,690,5462,5265,5670,4893
2019-08-21,502375,477896,466297,424364,570063,544284,533600,489117,67688,66388,67303,64753,47,47,49,45,740,729,775,690,5462,5265,5670,4893
2019-08-22,503936,479457,467858,425925,571867,546088,535404,490921,67931,66631,67546,64996,47,47,49,45,741,730,776,691,5473,5276,5681,4904
2019-08-23,503720,479241,467642,425709,571867,546088,535404,490921,68147,66847,67762,65212,47,47,49,45,741,730,776,691,5473,5276,5681,4904
2019-08-24,504053,479646,468047,426114,572488,546709,536025,491542,68435,67063,67978,65428,47,47,49,45,741,730,776,691,5476,5279,5684,4907
2019-08-25,503933,479526,467927,425982,572656,546877,536193,491626,68723,67351,68266,65644,47,47,49,45,745,734,780,693,5524,5327,5736,4927
2019-08-31,503906,479499,467900,425955,572845,547066,536382,491815,68939,67567,68482,65860,47,47,49,45,745,734,780,693,5533,5336,5745,4936
2019-09-01,503663,479256,467657,425712,572845,547066,536382,491815,69182,67810,68725,66103,47,47,49,45,745,734,780,693,5533,5336,5745,4936
2019-09-07,504725,480318,468719,426774,574195,548416,537732,493165,69470,68098,69013,66391,47,47,49,45,748,737,783,696,5569,5372,5781,4972
2019-09-08,504710,480303,468704,426558,574423,548644,537960,493165,69713,68341,69256,66607,47,47,49,45,748,737,783,696,5575,5378,5787,4972
2019-09-14,505218,480771,469172,427026,575219,549400,538716,493921,70001,68629,69544,66895,47,47,49,45,750,739,785,698,5599,5400,5809,4994
2019-09-21,505002,480555,468956,426738,575219,549400,538716,493921,70217,68845,69760,67183,47,47,49,45,750,739,785,698,5599,5400,5809,4994
2019-09-28,504826,480379,468780,426632,575331,549512,538828,493977,70505,69133,70048,67345,47,47,49,45,750,739,785,698,5603,5404,5813,4996
2019-09-29,504586,480091,468492,426344,575331,549512,538828,493977,70745,69421,70336,67633,47,47,49,45,750,739,785,698,5603,5404,5813,4996
2019-10-05,504427,479932,468333,426158,575415,549596,538912,494061,70988,69664,70579,67903,47,47,49,45,750,739,785,698,5606,5407,5816,4999
2019-10-12,504211,479689,468090,425915,575415,549596,538912,494061,71204,69907,70822,68146,47,47,49,45,750,739,785,698,5606,5407,5816,4999
2019-10-19,507065,482561,470962,428787,578539,552684,542000,497149,71474,70123,71038,68362,48,48,50,46,762,750,796,709,5663,5458,5867,5050
2019-10-26,506993,482489,470890,428811,578737,552882,542198,497413,71744,70393,71308,68602,48,48,50,46,762,750,796,709,5666,5461,5870,5054
2019-10-27,506981,482477,470878,428799,579013,553158,542474,497689,72032,70681,71596,68890,49,49,51,47,774,762,808,721,5724,5519,5928,5112
2019-11-02,507494,482918,471319,429240,579742,553887,543203,498418,72248,70969,71884,69178,49,49,51,47,774,762,808,721,5733,5528,5937,5121
2019-11-09,507350,482774,471175,429096,579838,553983,543299,498514,72488,71209,72124,69418,49,49,51,47,774,762,808,721,5737,5532,5941,5125
2019-11-10,507134,482742,471143,429064,579838,554239,543555,498770,72704,71497,72412,69706,49,49,51,47,774,762,808,721,5737,5540,5949,5133
2019-11-16,508102,483710,472111,430010,581076,555477,544793,499986,72974,71767,72682,69976,50,50,52,48,787,775,821,733,5803,5606,6015,5190
2019-11-23,508333,483941,472342,430268,581550,555951,545267,500460,73217,72010,72925,70192,50,50,52,48,787,775,821,733,5809,5612,6021,5196
2019-11-30,508294,483902,472303,430256,581754,556155,545471,500664,73460,72253,73168,70408,50,50,52,48,787,775,821,733,5815,5618,6027,5202
2019-12-01,510373,484046,472447,430400,584121,556515,545831,501024,73748,72469,73384,70624,50,50,52,48,790,775,821,733,5851,5627,6036,5211
2019-12-07,528478,501750,490151,448104,602442,574435,563751,518944,73964,72685,73600,70840,51,51,53,49,801,785,831,743,5900,5670,6079,5254
2019-12-14,528262,501462,489863,447816,602442,574435,563751,518944,74180,72973,73888,71128,51,51,53,49,801,785,831,743,5900,5670,6079,5254
2019-12-21,531330,504530,492931,450884,605766,577759,567075,522268,74436,73229,74144,71384,51,51,53,49,805,789,835,747,5948,5718,6127,5302
2019-12-23,531948,504290,492691,450644,606654,577759,567075,522268,74706,73469,74384,71624,51,51,53,49,805,789,835,747,5954,5718,6127,5302
2019-12-25,532164,504506,492907,450860,607158,578263,567579,522772,74994,73757,74672,71912,51,51,53,49,805,789,835,747,5966,5730,6139,5314
2019-12-26,535027,504322,492723,450676,610291,578367,567683,522876,75264,74045,74960,72200,52,51,53,49,817,791,837,749,6024,5752,6161,5336
2019-12-27,534784,504160,492561,450514,610291,578367,567683,522876,75507,74207,75122,72362,52,51,53,49,817,791,837,749,6024,5752,6161,5336
2019-12-28,534496,503872,492273,450298,610291,578367,567683,522876,75795,74495,75410,72578,52,51,53,49,817,791,837,749,6024,5752,6161,5336
2019-12-29,534226,503602,491990,450028,610291,578367,567683,522876,76065,74765,75693,72848,52,51,53,49,817,791,837,749,6024,5752,6161,5336
2019-12-30,534010,503386,491774,449740,610291,578367,567683,522876,76281,74981,75909,73136,52,51,53,49,817,791,837,749,6024,5752,6161,5336
2019-12-31,553270,522285,510673,468639,629794,597482,586798,541991,76524,75197,76125,73352,53,52,54,50,828,801,847,759,6078,5796,6205,5380
2020-01-04,553622,522123,510511,468477,630362,597482,586798,541991,76740,75359,76287,73514,53,52,54,50,828,801,847,759,6086,5796,6205,5380
2020-01-11,558158,526443,514831,472797,635114,602018,591334,546527,76956,75575,76503,73730,53,52,54,50,831,804,850,762,6119,5826,6235,5410
2020-01-18,559259,527087,515475,473441,636485,602932,592248,547441,77226,75845,76773,74000,53,52,54,50,831,804,850,762,6122,5828,6237,5412
2020-01-25,559043,526871,515259,473225,636485,602932,592248,547441,77442,76061,76989,74216,53,52,54,50,831,804,850,762,6122,5828,6237,5412
2020-02-01,559043,526871,515259,473225,636701,603148,592464,547657,77658,76277,77205,74432,53,52,54,50,834,807,853,765,6155,5861,6270,5445
2020-02-08,562292,528893,517281,475247,640166,605458,594774,549967,77874,76565,77493,74720,53,52,54,50,837,809,855,767,6188,5883,6292,5467
2020-02-15,562004,528605,516993,474959,640166,605458,594774,549967,78162,76853,77781,75008,53,52,54,50,837,809,855,767,6188,5883,6292,5467
2020-02-22,562979,528443,516831,474797,641384,605458,594774,549967,78405,77015,77943,75170,53,52,54,50,837,809,855,767,6194,5883,6292,5467
2020-02-29,562991,528455,516843,474733,641612,605686,595002,550119,78621,77231,78159,75386,53,52,54,50,840,812,858,769,6227,5916,6325,5487
2020-03-07,562751,528199,516587,474477,641612,605686,595002,550119,78861,77487,78415,75642,53,52,54,50,840,812,858,769,6227,5916,6325,5487
2020-03-14,562567,527943,516331,474221,641644,605718,595034,550151,79077,77775,78703,75930,53,52,54,50,842,814,860,771,6249,5938,6347,5509
2020-03-21,563111,528445,516833,474723,642476,606508,595824,550941,79365,78063,78991,76218,53,52,54,50,844,816,862,773,6273,5960,6369,5531
2020-03-28,562868,528202,516590,474480,642476,606508,595824,550941,79608,78306,79234,76461,53,52,54,50,844,816,862,773,6273,5960,6369,5531
2020-04-04,565538,530872,519260,477112,645416,609448,598764,553789,79878,78576,79504,76677,54,53,55,51,856,828,874,783,6332,6019,6428,5575
2020-04-09,565487,530730,519118,476970,645527,609522,598838,553863,80040,78792,79720,76893,54,53,55,51,856,828,874,783,6335,6021,6430,5577
2020-04-10,626401,591644,518981,537751,706729,670724,598971,614932,80328,79080,79990,77181,55,54,55,52,869,841,875,795,6402,6088,6443,5641
2020-04-11,626113,591356,518693,537463,706729,670724,598971,614932,80616,79368,80278,77469,55,54,55,52,869,841,875,795,6402,6088,6443,5641
2020-04-12,625897,592748,520085,538855,706729,672404,600651,616612,80832,79656,80566,77757,55,54,55,52,869,841,875,795,6402,6094,6449,5647
2020-04-18,625857,592708,520045,538815,706905,672580,600827,616788,81048,79872,80782,77973,55,54,55,52,873,845,879,799,6450,6142,6497,5695
2020-04-25,625709,592560,519897,538667,706997,672672,600919,616880,81288,80112,81022,78213,55,54,55,52,875,847,881,801,6476,6168,6523,5721
2020-05-02,625745,592596,519933,538637,707276,672951,601198,617066,81531,80355,81265,78429,55,54,55,52,878,850,884,803,6509,6201,6556,5741
2020-05-09,625457,592380,519717,538421,707276,672951,601198,617066,81819,80571,81481,78645,55,54,55,52,878,850,884,803,6509,6201,6556,5741
2020-05-16,625311,592294,519631,538335,707370,673045,601292,617160,82059,80751,81661,78825,55,54,55,52,880,852,886,805,6533,6223,6578,5763
2020-05-17,625023,592006,519343,538047,707370,673045,601292,617160,82347,81039,81949,79113,55,54,55,52,880,852,886,805,6533,6223,6578,5763
2020-05-23,627055,593380,520717,539421,709690,674707,602954,618822,82635,81327,82237,79401,55,54,55,52,884,855,889,808,6581,6256,6611,5796
2020-05-30,626895,593220,520569,539181,709690,674707,603094,618822,82795,81487,82525,79641,55,54,55,52,884,855,891,808,6591,6266,6639,5796
2020-05-31,628026,594351,521787,540288,711109,676126,604537,620217,83083,81775,82750,79929,56,55,56,53,896,867,904,819,6655,6330,6711,5849
2020-06-06,628473,594135,521571,540072,711772,676126,604537,620217,83299,81991,82966,80145,56,55,56,53,896,867,904,819,6658,6330,6711,5849
2020-06-13,628966,594628,522064,540577,712508,676862,605273,620938,83542,82234,83209,80361,57,56,57,54,907,878,915,829,6712,6384,6765,5893
2020-06-14,628678,594340,521776,540361,712508,676862,605273,620938,83830,82522,83497,80577,57,56,57,54,907,878,915,829,6712,6384,6765,5893
2020-06-21,628538,594200,521636,540221,712656,677010,605421,621086,84118,82810,83785,80865,57,56,57,54,909,880,917,831,6736,6408,6789,5917
2020-06-27,628577,594082,521518,540103,712911,677180,605591,621256,84334,83098,84073,81153,57,56,57,54,912,882,919,833,6769,6430,6811,5939
2020-07-02,628433,593938,523920,539815,713055,677324,608263,621256,84622,83386,84343,81441,57,56,58,54,916,886,932,833,6817,6478,6881,5947
2020-07-04,628190,593722,523704,539599,713055,677324,608263,621256,84865,83602,84559,81657,57,56,58,54,916,886,932,833,6826,6484,6887,5953
2020-07-05,664494,593713,523695,539590,749647,677477,608416,621409,85153,83764,84721,81819,58,56,58,54,928,886,932,833,6884,6487,6890,5956
2020-07-11,664206,593425,523455,539302,749647,677477,608416,621409,85441,84052,84961,82107,58,56,58,54,928,886,932,833,6890,6493,6896,5962
2020-07-18,663966,593185,523215,539062,749647,677477,608416,621409,85681,84292,85201,82347,58,56,58,54,928,886,932,833,6890,6493,6896,5962
2020-07-19,663873,593092,523122,538996,749797,677627,608566,621559,85924,84535,85444,82563,58,56,58,54,931,889,935,836,6923,6526,6929,5992
2020-07-25,663585,592804,522834,538708,749797,677627,608566,621559,86212,84823,85732,82851,58,56,58,54,931,889,935,836,6923,6526,6929,5992
2020-07-28,663297,593156,523186,539060,749797,678267,609206,622199,86500,85111,86020,83139,58,56,58,54,931,889,935,836,6923,6534,6937,6000
2020-08-01,663054,592940,522970,538844,749797,678267,609206,622199,86743,85327,86236,83355,58,56,58,54,931,889,935,836,6923,6534,6937,6000
2020-08-08,662766,593132,523162,539036,749797,678675,609614,622607,87031,85543,86452,83571,58,56,58,54,931,889,935,836,6923,6540,6943,6006
2020-08-09,662523,592916,522946,538820,749797,678675,609614,622607,87274,85759,86668,83787,58,56,58,54,931,889,935,836,6923,6540,6943,6006
2020-08-15,662307,592628,522658,538532,749797,678675,609614,622607,87490,86047,86956,84075,58,56,58,54,931,889,935,836,6923,6540,6943,6006
2020-08-19,662585,592896,522926,538800,750345,679159,610098,623091,87760,86263,87172,84291,58,56,58,54,933,891,937,838,6947,6560,6963,6026
2020-08-22,662423,592734,522656,538638,750345,679159,610098,623091,87922,86425,87442,84453,58,56,58,54,933,891,937,838,6956,6569,6975,6035
2020-08-25,662165,592476,522430,540597,750375,679189,610128,625338,88210,86713,87698,84741,58,56,58,55,934,892,938,849,6968,6581,6988,6087
2020-08-29,661949,592188,522274,540309,750375,679189,610242,625338,88426,87001,87968,85029,58,56,58,55,934,892,940,849,6970,6585,7012,6091
2020-08-30,665073,595312,525398,542472,753715,682529,613582,627717,88642,87217,88184,85245,58,56,58,55,938,896,944,852,7014,6629,7056,6121
2020-09-05,664911,595096,525182,542256,753715,682529,613582,627717,88804,87433,88400,85461,58,56,58,55,938,896,944,852,7014,6629,7056,6121
2020-09-06,665439,595080,525166,542240,754531,682801,613854,627989,89092,87721,88688,85749,58,56,58,55,938,896,944,852,7026,6633,7060,6125
2020-09-12,666777,595828,525914,542988,756157,683837,614890,629025,89380,88009,88976,86037,58,56,58,55,941,898,946,854,7065,6657,7084,6149
2020-09-13,666639,595690,525776,542850,756307,683987,615040,629175,89668,88297,89264,86325,58,56,58,55,943,900,948,856,7089,6679,7106,6171
2020-09-19,667263,596314,526400,543378,757123,684803,615856,629991,89860,88489,89456,86613,58,56,58,55,943,900,948,856,7101,6691,7118,6183
2020-09-26,667675,596412,526498,543476,757751,685117,616170,630305,90076,88705,89672,86829,58,56,58,55,943,900,948,856,7105,6693,7120,6185
2020-09-27,667504,596241,526390,543305,757868,685234,616287,630422,90364,88993,89897,87117,58,56,58,55,946,903,951,859,7141,6729,7159,6221
2020-10-03,667663,596400,526549,543464,758327,685693,616746,630881,90664,89293,90197,87417,59,57,59,56,959,916,964,872,7210,6798,7228,6290
2020-10-10,667483,596112,526261,543176,758327,685693,616746,630881,90844,89581,90485,87705,59,57,59,56,959,916,964,872,7210,6798,7228,6290
2020-10-17,678597,596690,526839,543754,769684,686433,617486,631621,91087,89743,90647,87867,60,57,59,56,970,918,966,874,7264,6818,7248,6310
2020-10-24,678765,596858,527007,543922,770140,686889,617942,632077,91375,90031,90935,88155,61,58,60,57,982,929,978,885,7325,6870,7309,6362
2020-10-25,678577,596670,526819,543816,770195,686944,617997,632187,91618,90274,91178,88371,61,58,60,57,983,930,979,887,7336,6881,7320,6382
2020-10-31,679081,597174,527323,544320,770969,687718,618771,632961,91888,90544,91448,88641,61,58,60,57,985,932,981,889,7360,6905,7344,6406
2020-11-07,678838,596931,527080,544077,770969,687718,618771,632961,92131,90787,91691,88884,61,58,60,57,985,932,981,889,7360,6905,7344,6406
2020-11-08,678778,596871,527020,543999,771179,687928,618981,633171,92401,91057,91961,89172,61,58,60,57,988,935,984,892,7396,6941,7380,6439
2020-11-14,680017,598110,528259,545264,772706,689455,620508,634679,92689,91345,92249,89415,62,59,61,58,1000,947,996,903,7456,7001,7440,6491
2020-11-21,679988,598268,528417,545422,772893,689829,620882,635053,92905,91561,92465,89631,62,59,61,58,1000,947,996,903,7457,7003,7442,6493
2020-11-28,679772,598025,528174,545179,772893,689829,620882,635053,93121,91804,92708,89874,62,59,61,58,1000,947,996,903,7457,7003,7442,6493
2020-12-05,680732,598985,529134,545679,774141,691077,622130,635841,93409,92092,92996,90162,62,59,61,58,1003,950,999,905,7493,7039,7478,6515
2020-12-12,680552,598715,528864,545409,774141,691077,622130,635841,93589,92362,93266,90432,62,59,61,58,1003,950,999,905,7493,7039,7478,6515
2020-12-19,680750,598751,528900,545445,774627,691401,622454,636165,93877,92650,93554,90720,62,59,61,58,1003,950,999,905,7499,7043,7482,6519
2020-12-23,680800,599139,529288,545833,774965,692077,623130,636841,94165,92938,93842,91008,62,59,61,58,1003,950,999,905,7501,7047,7486,6523
2020-12-25,680548,599473,529622,546167,775001,692699,623752,637463,94453,93226,94130,91296,62,59,61,58,1003,952,1001,907,7503,7069,7508,6545
2020-12-26,681111,600036,530185,545951,775807,693505,624558,637463,94696,93469,94373,91512,62,59,61,58,1005,954,1003,907,7525,7091,7530,6545
2020-12-27,681463,600388,530537,546303,776375,694073,625126,638031,94912,93685,94589,91728,62,59,61,58,1005,954,1003,907,7529,7095,7534,6549
2020-12-28,683396,602276,532425,548191,778551,696249,627302,640207,95155,93973,94877,92016,63,60,62,59,1016,965,1014,918,7579,7151,7590,6605
2020-12-29,683276,602052,532201,547967,778647,696313,627366,640271,95371,94261,95165,92304,63,60,62,59,1016,965,1014,918,7585,7155,7594,6609
2020-12-30,683060,601764,531913,547679,778647,696313,627366,640271,95587,94549,95453,92592,63,60,62,59,1016,965,1014,918,7585,7155,7594,6609
2020-12-31,682817,601602,531751,547517,778647,696313,627366,640271,95830,94711,95615,92754,63,60,62,59,1016,965,1014,918,7585,7155,7594,6609
2021-01-02,682601,601386,531535,547301,778647,696313,627366,640271,96046,94927,95831,92970,63,60,62,59,1016,965,1014,918,7585,7155,7594,6609
2021-01-09,683613,602334,532483,548249,779862,697504,628557,641462,96248,95170,96074,93213,64,61,63,60,1028,976,1025,929,7641,7205,7644,6659
2021-01-16,683370,602172,532321,548087,779862,697504,628557,641462,96491,95332,96236,93375,64,61,63,60,1028,976,1025,929,7641,7205,7644,6659
2021-01-23,683254,601956,532105,547871,780034,697504,628557,641462,96779,95548,96452,93591,64,61,63,60,1028,976,1025,929,7645,7205,7644,6659
2021-01-30,683071,601740,531889,547655,780121,697504,628557,641462,97049,95764,96668,93807,64,61,63,60,1028,976,1025,929,7646,7205,7644,6659
2021-02-06,682919,601588,531737,547544,780257,697640,628693,641513,97337,96052,96956,93969,64,61,63,60,1028,976,1025,929,7654,7213,7652,6662
2021-02-13,682703,601372,531521,547328,780257,697640,628693,641513,97553,96268,97172,94185,64,61,63,60,1028,976,1025,929,7654,7213,7652,6662
2021-02-20,682523,601084,531233,547040,780257,697640,628693,641513,97733,96556,97460,94473,64,61,63,60,1028,976,1025,929,7654,7213,7652,6662
2021-02-27,683103,600844,530993,546800,781077,697640,628693,641513,97973,96796,97700,94713,64,61,63,60,1028,976,1025,929,7658,7213,7652,6662
2021-03-06,683697,601438,531587,547394,781887,698450,629503,642323,98189,97012,97916,94929,64,61,63,60,1028,976,1025,929,7664,7219,7658,6668
2021-03-13,684387,602128,532277,547770,782865,699428,630481,642915,98477,97300,98204,95145,64,61,63,60,1031,979,1028,931,7700,7255,7694,6688
2021-05-01,684287,602028,532177,547670,782981,699544,630597,643031,98693,97516,98420,95361,64,61,63,60,1031,979,1028,931,7704,7259,7698,6692
2021-05-08,686634,601857,532006,547499,785598,699589,630642,643076,98963,97732,98636,95577,65,61,63,60,1043,980,1029,932,7765,7270,7709,6703
2021-05-15,686418,601641,531790,547283,785598,699589,630642,643076,99179,97948,98852,95793,65,61,63,60,1043,980,1029,932,7777,7279,7718,6712
2021-05-22,688802,604025,534174,547243,788198,702189,633242,643324,99395,98164,99068,96081,65,61,63,60,1047,984,1033,932,7821,7323,7762,6720
2021-05-29,690362,605195,535344,548413,790046,703575,634628,644710,99683,98380,99284,96297,65,61,63,60,1047,984,1033,932,7833,7332,7771,6729
2021-05-30,690146,605033,535128,548251,790046,703575,634628,644710,99899,98542,99500,96459,65,61,63,60,1047,984,1033,932,7833,7332,7771,6729
2021-06-05,689966,604853,534948,548071,790046,703575,634628,644710,100079,98722,99680,96639,65,61,63,60,1047,984,1033,932,7833,7332,7771,6729
2021-06-12,690836,605723,535818,547855,791186,704715,635768,644710,100349,98992,99950,96855,65,61,63,60,1047,984,1033,932,7835,7334,7773,6729
2021-06-19,690812,605699,535794,547831,791378,704907,635960,644902,100565,99208,100166,97071,65,61,63,60,1047,984,1033,932,7837,7336,7775,6731
2021-06-27,691637,606524,536619,548656,792491,706020,637073,646015,100853,99496,100454,97359,65,61,63,60,1050,987,1036,935,7873,7372,7811,6767
2021-07-03,691337,606284,536379,548416,792491,706020,637073,646015,101153,99736,100694,97599,65,61,63,60,1050,987,1036,935,7873,7372,7811,6767
2021-07-10,692460,607407,537502,549539,793830,707359,638412,647354,101369,99952,100910,97815,66,62,64,61,1061,998,1047,946,7924,7423,7862,6818
2021-07-17,692217,607191,537286,549323,793830,707359,638412,647354,101612,100168,101126,98031,66,62,64,61,1061,998,1047,946,7924,7423,7862,6818
2021-07-31,693630,608604,538699,550736,795486,709015,640068,649010,101855,100411,101369,98274,67,63,65,62,1072,1009,1058,957,7978,7477,7916,6872
2021-08-07,693774,608676,538771,550808,795846,709375,640428,649370,102071,100699,101657,98562,67,63,65,62,1072,1009,1058,957,7986,7485,7924,6880
2021-08-14,693584,608486,538581,552075,795872,709401,640454,650853,102287,100915,101873,98778,67,63,65,63,1073,1010,1059,968,7997,7496,7935,6933
2021-08-18,693344,608246,538341,551787,795872,709401,640454,650853,102527,101155,102113,99066,67,63,65,63,1073,1010,1059,968,7997,7496,7935,6933
2021-08-21,693560,608462,538557,551835,796376,709905,640958,651189,102815,101443,102401,99354,67,63,65,63,1073,1010,1059,968,8003,7502,7941,6937
2021-08-24,693421,608323,538418,551696,796525,710054,641107,651338,103103,101731,102689,99642,68,64,66,64,1085,1022,1071,980,8062,7561,8000,6995
2021-08-28,693133,608035,538130,551480,796525,710054,641107,651338,103391,102019,102977,99858,68,64,66,64,1085,1022,1071,980,8062,7561,8000,6995
2021-09-04,692863,607795,537890,551240,796525,710054,641107,651338,103661,102259,103217,100098,68,64,66,64,1085,1022,1071,980,8062,7561,8000,6995
2021-09-11,692647,607552,537647,550997,796525,710054,641107,651338,103877,102502,103460,100341,68,64,66,64,1085,1022,1071,980,8062,7561,8000,6995
2021-09-18,692359,607336,537359,550781,796525,710054,641107,651338,104165,102718,103748,100557,68,64,66,64,1085,1022,1071,980,8062,7561,8000,6995
2021-09-25,692071,607048,537231,550565,796525,710054,641249,651338,104453,103006,104018,100773,68,64,66,64,1085,1022,1073,980,8070,7569,8028,6998
2021-10-09,691815,606792,536975,550277,796525,710054,641249,651338,104709,103262,104274,101061,68,64,66,64,1085,1022,1073,980,8074,7573,8032,7002
2021-10-16,691559,606536,536719,550034,796525,710054,641249,651338,104965,103518,104530,101304,68,64,66,64,1085,1022,1073,980,8074,7573,8032,7002
2021-10-23,691448,606425,536608,549995,796702,710231,641426,651515,105253,103806,104818,101520,68,64,66,64,1088,1025,1076,983,8110,7609,8068,7032
2021-10-24,691408,606385,536548,549783,796854,710383,641654,651591,105445,103998,105106,101808,68,64,66,64,1090,1027,1079,984,8134,7633,8107,7045
2021-10-30,691138,606097,536260,549495,796854,710383,641654,651591,105715,104286,105394,102096,68,64,66,64,1090,1027,1079,984,8134,7633,8107,7045
2021-11-06,690898,605857,536020,549255,796854,710383,641654,651591,105955,104526,105634,102336,68,64,66,64,1090,1027,1079,984,8134,7633,8107,7045
2021-11-13,690610,605569,535732,548967,796854,710383,641654,651591,106243,104814,105922,102624,68,64,66,64,1090,1027,1079,984,8134,7633,8107,7045
2021-11-20,690367,605326,535489,548805,796854,710383,641654,651591,106486,105057,106165,102786,68,64,66,64,1090,1027,1079,984,8143,7642,8116,7054
2021-11-27,690261,605220,535383,548771,797036,710565,641836,651773,106774,105345,106453,103002,68,64,66,64,1092,1029,1081,986,8167,7666,8140,7076
2021-12-04,691300,606213,536376,549764,798345,711774,643045,652982,107044,105561,106669,103218,68,64,66,64,1093,1030,1082,987,8180,7677,8151,7087
2021-12-11,691012,605925,536088,549476,798345,711774,643045,652982,107332,105849,106957,103506,68,64,66,64,1093,1030,1082,987,8180,7677,8151,7087
2021-12-18,690904,605799,535962,549350,798480,711864,643135,653072,107575,106065,107173,103722,68,64,66,64,1093,1030,1082,987,8189,7683,8157,7093
2021-12-23,690616,605637,535800,549188,798480,711864,643135,653072,107863,106227,107335,103884,68,64,66,64,1093,1030,1082,987,8189,7683,8157,7093
2021-12-31,690328,605349,535512,548900,798480,711864,643135,653072,108151,106515,107623,104172,68,64,66,64,1093,1030,1082,987,8189,7683,8157,7093
2022-01-01,692101,607053,537216,550604,800496,713784,645055,654992,108394,106731,107839,104388,68,64,66,64,1096,1033,1085,990,8222,7713,8187,7123
2022-01-08,692176,606837,537000,550388,800814,713784,645055,654992,108637,106947,108055,104604,68,64,66,64,1096,1033,1085,990,8228,7713,8187,7123
2022-01-15,696065,610660,540823,554211,804991,717895,649166,659103,108925,107235,108343,104892,69,65,67,65,1108,1044,1096,1001,8295,7769,8243,7179
2022-01-22,695921,612308,542471,555859,805135,719831,651102,661039,109213,107523,108631,105180,69,65,67,65,1108,1046,1098,1003,8298,7791,8265,7201
2022-01-29,703626,612592,542755,556143,813128,720403,651674,661611,109501,107811,108919,105468,70,65,67,65,1120,1048,1100,1005,8362,7813,8287,7223
2022-02-05,703383,612349,542512,555927,813128,720403,651674,661611,109744,108054,109162,105684,70,65,67,65,1120,1048,1100,1005,8362,7813,8287,7223
2022-02-12,715632,612693,542856,556271,825647,721035,652306,662243,110014,108342,109450,105972,71,65,67,65,1132,1050,1102,1007,8427,7835,8309,7245
2022-02-19,715632,612693,542856,556109,825935,721323,652594,662243,110302,108630,109738,106134,71,65,67,65,1135,1053,1105,1007,8463,7871,8345,7254
2022-02-26,715416,612405,542568,555821,825935,721323,652594,662243,110518,108918,110026,106422,71,65,67,65,1135,1053,1105,1007,8463,7871,8345,7254
2022-03-05,715146,612135,542298,555551,825935,721323,652594,662243,110788,109188,110296,106692,71,65,67,65,1135,1053,1105,1007,8463,7871,8345,7254
2022-03-12,714858,611847,542010,555263,825935,721323,652594,662243,111076,109476,110584,106980,71,65,67,65,1135,1053,1105,1007,8463,7871,8345,7254
2022-03-19,714790,611779,541942,555195,826155,721543,652814,662463,111364,109764,110872,107268,71,65,67,65,1135,1053,1105,1007,8467,7875,8349,7258
2022-03-26,714610,611599,541762,555015,826245,721603,652874,662523,111634,110004,111112,107508,71,65,67,65,1135,1053,1105,1007,8473,7879,8353,7262
2022-04-02,715903,612892,543055,556374,827826,723184,654455,664074,111922,110292,111400,107700,72,66,68,66,1147,1065,1117,1018,8531,7937,8411,7310
2022-04-14,715795,612784,542947,556266,827934,723292,654563,664182,112138,110508,111616,107916,72,66,68,66,1147,1065,1117,1018,8537,7943,8417,7316
2022-04-15,715579,612568,542731,556050,827934,723292,654563,664182,112354,110724,111832,108132,72,66,68,66,1147,1065,1117,1018,8537,7943,8417,7316
2022-04-16,715291,612280,542443,555834,827934,723292,654563,664182,112642,111012,112120,108348,72,66,68,66,1147,1065,1117,1018,8537,7943,8417,7316
2022-04-17,715102,612103,542266,555657,828045,723403,654674,664293,112942,111300,112408,108636,72,66,68,66,1148,1066,1118,1019,8553,7956,8430,7329
2022-04-23,714886,620659,550822,564213,828045,732247,663518,673137,113158,111588,112696,108924,72,66,68,66,1148,1066,1118,1019,8553,7962,8436,7335
2022-04-30,714598,620443,550606,563997,828045,732247,663518,673137,113446,111804,112912,109140,72,66,68,66,1148,1066,1118,1019,8553,7962,8436,7335
2022-05-07,714514,620359,550522,563861,828201,732403,663674,673241,113686,112044,113152,109380,72,66,68,66,1151,1069,1121,1021,8589,7998,8472,7357
2022-05-14,714378,620223,555476,563725,828353,732555,668898,673393,113974,112332,113422,109668,72,66,69,66,1155,1073,1134,1025,8637,8046,8542,7405
2022-05-21,716222,621911,557164,565413,830437,734531,670874,675369,114214,112620,113710,109956,72,66,69,66,1159,1077,1138,1029,8685,8090,8586,7449
2022-05-28,719501,625118,560371,568620,833932,738026,674369,678864,114430,112908,113998,110244,73,67,70,67,1170,1088,1149,1040,8737,8143,8639,7502
2022-05-29,719717,625208,560461,568710,834436,738404,674747,679242,114718,113196,114286,110532,73,67,70,67,1170,1088,1149,1040,8745,8149,8645,7508
2022-06-04,719615,625106,560359,568608,834622,738590,674933,679428,115006,113484,114574,110820,73,67,70,67,1170,1088,1149,1040,8751,8155,8651,7514
2022-06-11,719488,624979,565340,568481,834687,738655,680202,679493,115198,113676,114862,111012,73,67,71,67,1171,1089,1162,1041,8763,8167,8724,7526
2022-06-12,719752,625243,565604,568319,835239,739207,680754,679493,115486,113964,115150,111174,73,67,71,67,1171,1089,1162,1041,8771,8175,8732,7526
2022-06-18,719527,625078,565439,568154,835284,739222,680769,679508,115756,114144,115330,111354,73,67,71,67,1174,1090,1163,1042,8807,8187,8744,7538
2022-06-26,719239,624790,565151,567938,835284,739222,680769,679508,116044,114432,115618,111570,73,67,71,67,1174,1090,1163,1042,8807,8187,8744,7538
2022-07-02,718996,624574,564935,567722,835284,739222,680769,679508,116287,114648,115834,111786,73,67,71,67,1174,1090,1163,1042,8807,8187,8744,7538
2022-07-09,719281,624859,565220,567802,835839,739777,681324,679804,116557,114918,116104,112002,73,67,71,67,1174,1090,1163,1042,8822,8202,8759,7546
2022-07-10,719441,625019,565380,567962,836269,740207,681754,680234,116827,115188,116374,112272,74,68,72,68,1186,1102,1175,1054,8879,8259,8816,7603
2022-07-16,719251,624829,565190,567772,836367,740305,681852,680332,117115,115476,116662,112560,74,68,72,68,1188,1104,1177,1056,8903,8283,8840,7625
2022-07-23,718963,624541,564902,567484,836367,740305,681852,680332,117403,115764,116950,112848,74,68,72,68,1188,1104,1177,1056,8903,8283,8840,7625
2022-07-24,718675,624325,564686,567268,836367,740305,681852,680332,117691,115980,117166,113064,74,68,72,68,1188,1104,1177,1056,8903,8283,8840,7625
2022-07-30,718459,624109,564470,566980,836367,740305,681852,680332,117907,116196,117382,113352,74,68,72,68,1188,1104,1177,1056,8903,8283,8840,7625
2022-08-06,718171,623821,564182,566692,836367,740305,681852,680332,118195,116484,117670,113640,74,68,72,68,1188,1104,1177,1056,8903,8283,8840,7625
2022-08-07,718375,624025,564386,566923,836814,740752,682299,680779,118438,116727,117913,113856,75,69,73,69,1199,1115,1188,1066,8953,8333,8890,7669
2022-08-13,719677,623737,564098,566635,838404,740752,682299,680779,118726,117015,118201,114144,75,69,73,69,1199,1115,1188,1066,8959,8333,8890,7669
2022-08-17,719491,623551,563912,566449,838458,740806,682353,680833,118966,117255,118441,114384,75,69,73,69,1200,1116,1189,1067,8972,8345,8902,7681
2022-08-20,719391,623451,563812,566349,838646,740994,682541,681021,119254,117543,118729,114672,75,69,73,69,1202,1118,1191,1069,8996,8369,8926,7705
2022-08-27,719121,623181,563572,566325,838646,740994,682541,681237,119524,117813,118969,114912,75,69,73,69,1202,1118,1191,1071,8998,8371,8929,7727
2022-09-03,718878,623019,563410,566163,838646,740994,682541,681237,119767,117975,119131,115074,75,69,73,69,1202,1118,1191,1071,8998,8371,8929,7727
2022-09-04,719024,623117,563556,566261,839032,741380,682927,681623,120007,118263,119371,115362,76,70,74,70,1214,1129,1203,1082,9054,8422,8986,7778
2022-09-11,718808,622901,564848,565973,839032,741380,684507,681623,120223,118479,119659,115650,76,70,74,70,1214,1129,1207,1082,9054,8422,9038,7778
2022-09-17,723810,627889,569836,570961,844322,746584,689711,686827,120511,118695,119875,115866,77,71,75,71,1226,1139,1217,1092,9115,8466,9082,7822
2022-09-24,725689,627800,569747,570872,846381,746675,689802,686918,120691,118875,120055,116046,77,71,75,71,1227,1139,1217,1092,9127,8467,9083,7823
2022-10-01,725419,627530,569567,570602,846381,746675,689802,686918,120961,119145,120235,116316,77,71,75,71,1227,1139,1217,1092,9127,8467,9083,7823
