datum,t1_vinst,t2_vinst,t3_vinst,t4_vinst,t1_utd,t2_utd,t3_utd,t4_utd,t1_kostn,t2_kostn,t3_kostn,t4_kostn,t1_7,t2_7,t3_7,t4_7,t1_6,t2_6,t3_6,t4_6,t1_5,t2_5,t3_5,t4_5
2016-06-11,-288,-72,-72,-72,0,168,168,168,288,240,240,240,0,0,0,0,0,0,0,0,0,4,4,4
2016-06-12,-576,-328,-328,-328,0,168,168,168,576,496,496,496,0,0,0,0,0,0,0,0,0,4,4,4
2016-06-18,-816,-568,-568,-568,48,216,216,216,864,784,784,784,0,0,0,0,0,0,0,0,3,7,7,7
2016-06-26,-1104,-856,-856,-856,48,216,216,216,1152,1072,1072,1072,0,0,0,0,0,0,0,0,3,7,7,7
2016-07-02,-1320,-1072,-1072,-1072,48,216,216,216,1368,1288,1288,1288,0,0,0,0,0,0,0,0,3,7,7,7
2016-07-07,-1608,-1360,-1360,-1360,48,216,216,216,1656,1576,1576,1576,0,0,0,0,0,0,0,0,3,7,7,7
2016-07-09,-1896,-1648,-1648,-1648,48,216,216,216,1944,1864,1864,1864,0,0,0,0,0,0,0,0,15,13,13,13
2016-07-10,-355,-1878,-1878,-1878,1841,274,274,274,2196,2152,2152,2152,1,0,0,0,13,2,2,2,78,37,37,37
2016-07-16,-611,-2166,-2166,-2166,1841,274,274,274,2452,2440,2440,2440,1,0,0,0,13,2,2,2,78,37,37,37
2016-07-23,-881,-2436,-2436,-2436,1841,274,274,274,2722,2710,2710,2710,1,0,0,0,13,2,2,2,78,37,37,37
2016-07-24,-1105,-2724,-2724,-2724,1841,274,274,274,2946,2998,2998,2998,1,0,0,0,13,2,2,2,78,37,37,37
2016-07-26,-1345,-2854,-2854,-2854,1841,324,324,324,3186,3178,3178,3178,1,0,0,0,13,2,2,2,78,39,39,39
2016-07-30,-1425,-3070,-3070,-3070,2049,324,324,324,3474,3394,3394,3394,1,0,0,0,13,2,2,2,86,39,39,39
2016-08-06,-1713,-3358,-3358,-3358,2049,324,324,324,3762,3682,3682,3682,1,0,0,0,13,2,2,2,86,39,39,39
2016-08-07,-2001,-3574,-3574,-3574,2049,324,324,324,4050,3898,3898,3898,1,0,0,0,13,2,2,2,86,39,39,39
2016-08-17,-2245,-3862,-3862,-3862,2093,324,324,324,4338,4186,4186,4186,1,0,0,0,14,2,2,2,98,43,43,43
2016-08-20,-2485,-4150,-4150,-4150,2093,324,324,324,4578,4474,4474,4474,1,0,0,0,14,2,2,2,98,43,43,43
2016-08-27,-2497,-4162,-4162,-4278,2261,492,492,436,4758,4654,4654,4714,1,0,0,0,14,2,2,2,104,49,49,47
2016-09-03,-2785,-4450,-4450,-4566,2261,492,492,436,5046,4942,4942,5002,1,0,0,0,14,2,2,2,104,49,49,47
2016-09-04,-3055,-4720,-4720,-4836,2261,492,492,436,5316,5212,5212,5272,1,0,0,0,14,2,2,2,107,52,52,50
2016-09-10,-3295,-4960,-4960,-5076,2261,492,492,436,5556,5452,5452,5512,1,0,0,0,16,4,4,4,131,74,74,72
2016-09-17,-3511,-5248,-5248,-5364,2261,492,492,436,5772,5740,5740,5800,1,0,0,0,16,4,4,4,131,74,74,72
2016-09-18,-2465,-4202,-4202,-5580,3607,1838,1838,436,6072,6040,6040,6016,2,1,1,0,29,17,17,4,200,143,143,78
2016-09-24,-2727,-4419,-4419,-5797,3633,1864,1864,462,6360,6283,6283,6259,2,1,1,0,30,18,18,5,213,154,154,89
2016-09-25,-3027,-4719,-4719,-6097,3633,1864,1864,462,6660,6583,6583,6559,2,1,1,0,30,18,18,5,213,154,154,89
2016-10-01,-3315,-4935,-4935,-6313,3633,1864,1864,462,6948,6799,6799,6775,2,1,1,0,30,18,18,5,221,160,160,95
2016-10-08,-3555,-5115,-5115,-6493,3633,1864,1864,462,7188,6979,6979,6955,2,1,1,0,30,18,18,5,221,160,160,95
2016-10-15,-3267,-4827,-4827,-6205,4137,2368,2368,966,7404,7195,7195,7171,2,1,1,0,31,19,19,6,233,172,172,107
2016-10-22,-3448,-5083,-5083,-6461,4181,2412,2412,1010,7629,7495,7495,7471,2,1,1,0,31,19,19,6,235,174,174,109
2016-10-23,-3736,-5371,-5371,-6749,4181,2412,2412,1010,7917,7783,7783,7759,2,1,1,0,31,19,19,6,247,186,186,121
2016-10-29,-3571,-5206,-5206,-6584,4586,2817,2817,1415,8157,8023,8023,7999,3,2,2,1,43,31,31,18,305,244,244,179
2016-11-05,-3871,-5366,-5366,-6744,4586,2817,2817,1415,8457,8183,8183,8159,3,2,2,1,43,31,31,18,305,244,244,179
2016-11-06,-4114,-5582,-5582,-6960,4586,2817,2817,1415,8700,8399,8399,8375,3,2,2,1,43,31,31,18,305,244,244,179
2016-11-12,-4228,-5702,-5702,-7080,4634,2913,2913,1511,8862,8615,8615,8591,3,2,2,1,43,31,31,18,308,250,250,185
2016-11-19,-4516,-5918,-5918,-7296,4634,2913,2913,1511,9150,8831,8831,8807,3,2,2,1,43,31,31,18,308,256,256,191
2016-11-26,-4759,-6161,-6161,-7539,4634,2913,2913,1511,9393,9074,9074,9050,3,2,2,1,43,31,31,18,308,256,256,191
2016-11-27,-4975,-6377,-6377,-7755,4634,2913,2913,1511,9609,9290,9290,9266,3,2,2,1,43,31,31,18,308,256,256,191
2016-12-03,-5245,-6647,-6647,-7971,4634,2913,2913,1511,9879,9560,9560,9482,3,2,2,1,43,31,31,18,314,262,262,197
2016-12-10,-5425,-6827,-6827,-8241,4634,2913,2913,1511,10059,9740,9740,9752,3,2,2,1,43,31,31,18,314,262,262,197
2016-12-17,-5573,-6975,-6975,-8389,4688,2967,2967,1565,10261,9942,9942,9954,3,2,2,1,43,31,31,18,317,265,265,200
2016-12-23,-5861,-7263,-7263,-8677,4688,2967,2967,1565,10549,10230,10230,10242,3,2,2,1,43,31,31,18,317,265,265,200
2016-12-25,-6149,-7551,-7551,-8965,4688,2967,2967,1565,10837,10518,10518,10530,3,2,2,1,43,31,31,18,317,265,265,200
2016-12-26,-6437,-7839,-7839,-9253,4688,2967,2967,1565,11125,10806,10806,10818,3,2,2,1,43,31,31,18,329,277,277,206
2016-12-27,-6725,-8082,-8082,-9496,4688,2967,2967,1565,11413,11049,11049,11061,3,2,2,1,43,31,31,18,329,277,277,206
2016-12-28,-7013,-8370,-8370,-9784,4688,2967,2967,1565,11701,11337,11337,11349,3,2,2,1,43,31,31,18,337,283,283,212
2016-12-29,-7301,-8586,-8586,-10000,4688,2967,2967,1565,11989,11553,11553,11565,3,2,2,1,43,31,31,18,337,283,283,212
2016-12-30,-7589,-8802,-8802,-10216,4688,2967,2967,1565,12277,11769,11769,11781,3,2,2,1,43,31,31,18,337,283,283,212
2016-12-31,-7769,-9090,-9090,-10504,4796,2967,2967,1565,12565,12057,12057,12069,3,2,2,1,43,31,31,18,341,283,283,212
2017-01-07,-8057,-9378,-9378,-10792,4796,2967,2967,1565,12853,12345,12345,12357,3,2,2,1,43,31,31,18,341,283,283,212
2017-01-14,-8222,-9531,-9531,-10945,4901,3030,3030,1628,13123,12561,12561,12573,3,2,2,1,43,31,31,18,346,286,286,215
2017-01-21,-8510,-9819,-9747,-11233,4901,3030,3030,1628,13411,12849,12777,12861,3,2,2,1,43,31,31,18,346,286,286,215
2017-01-28,-8678,-9891,-9819,-11305,4949,3174,3174,1772,13627,13065,12993,13077,3,2,2,1,43,31,31,18,348,292,292,221
2017-01-29,-8948,-10161,-10089,-11575,4949,3174,3174,1772,13897,13335,13263,13347,3,2,2,1,43,31,31,18,348,292,292,221
2017-02-04,-9160,-10373,-10301,-11787,4977,3202,3202,1800,14137,13575,13503,13587,3,2,2,1,43,31,31,18,349,293,293,222
2017-02-11,-9448,-10661,-10589,-12075,4977,3202,3202,1800,14425,13863,13791,13875,3,2,2,1,43,31,31,18,349,293,293,222
2017-02-18,-9736,-10949,-10877,-12291,4977,3202,3202,1800,14713,14151,14079,14091,3,2,2,1,43,31,31,18,349,293,293,222
2017-02-25,-9952,-11165,-11093,-12579,4977,3202,3202,1800,14929,14367,14295,14379,3,2,2,1,43,31,31,18,361,305,305,230
2017-02-26,-10208,-11421,-11349,-12835,4977,3202,3202,1800,15185,14623,14551,14635,3,2,2,1,43,31,31,18,361,305,305,230
2017-03-04,-10424,-11637,-11565,-13051,4977,3202,3202,1800,15401,14839,14767,14851,3,2,2,1,43,31,31,18,361,305,305,230
2017-03-11,-10694,-11907,-11835,-13321,4977,3202,3202,1800,15671,15109,15037,15121,3,2,2,1,43,31,31,18,361,305,305,230
2017-03-18,-9096,-12123,-12051,-13537,6818,3202,3202,1800,15914,15325,15253,15337,4,2,2,1,54,31,31,18,415,309,309,234
2017-03-25,-9018,-12045,-11973,-13459,7112,3496,3496,2094,16130,15541,15469,15553,4,2,2,1,54,31,31,18,418,312,312,237
2017-03-26,-9306,-12333,-12261,-13747,7112,3496,3496,2094,16418,15829,15757,15841,4,2,2,1,54,31,31,18,418,312,312,237
2017-04-01,-9576,-12621,-12549,-14035,7112,3496,3496,2094,16688,16117,16045,16129,4,2,2,1,54,31,31,18,418,312,312,237
2017-04-08,-9792,-12837,-12765,-14251,7112,3496,3496,2094,16904,16333,16261,16345,4,2,2,1,54,31,31,18,418,312,312,237
2017-04-14,-10092,-13053,-12981,-14467,7112,3496,3496,2094,17204,16549,16477,16561,4,2,2,1,54,31,31,18,418,312,312,237
2017-04-16,-10362,-13323,-13251,-14737,7112,3496,3496,2094,17474,16819,16747,16831,4,2,2,1,54,31,31,18,418,312,312,237
2017-04-22,-10602,-13503,-13431,-14917,7112,3496,3496,2094,17714,16999,16927,17011,4,2,2,1,54,31,31,18,418,312,312,237
2017-04-29,-10890,-13791,-13719,-15205,7112,3496,3496,2094,18002,17287,17215,17299,4,2,2,1,54,31,31,18,418,312,312,237
2017-05-01,-11098,-12919,-12847,-14333,7174,4656,4656,3254,18272,17575,17503,17587,4,2,2,1,54,33,33,20,420,334,334,259
2017-05-06,-11386,-13207,-13135,-14621,7174,4656,4656,3254,18560,17863,17791,17875,4,2,2,1,54,33,33,20,420,334,334,259
2017-05-07,-11554,-13426,-13354,-14840,7276,4707,4707,3305,18830,18133,18061,18145,4,2,2,1,54,33,33,20,426,337,337,262
2017-05-13,-11642,-13514,-13442,-14928,7428,4859,4859,3457,19070,18373,18301,18385,4,2,2,1,54,33,33,20,434,345,345,270
2017-05-14,-11858,-13706,-13634,-15120,7428,4859,4859,3457,19286,18565,18493,18577,4,2,2,1,54,33,33,20,434,345,345,270
2017-05-20,-12020,-13868,-13796,-15282,7428,4859,4859,3457,19448,18727,18655,18739,4,2,2,1,54,33,33,20,434,345,345,270
2017-05-27,-12308,-14156,-14084,-15570,7428,4859,4859,3457,19736,19015,18943,19027,4,2,2,1,54,33,33,20,434,345,345,270
2017-05-28,-12524,-14444,-14372,-15858,7428,4859,4859,3457,19952,19303,19231,19315,4,2,2,1,54,33,33,20,436,347,347,272
2017-06-03,-12812,-14660,-14588,-16074,7428,4859,4859,3457,20240,19519,19447,19531,4,2,2,1,54,33,33,20,436,347,347,272
2017-06-10,-12989,-14837,-14765,-16251,7503,4934,4934,3532,20492,19771,19699,19783,4,2,2,1,54,33,33,20,439,350,350,275
2017-06-11,-12719,-14837,-14765,-16251,8043,5114,5114,3712,20762,19951,19879,19963,4,2,2,1,54,33,33,20,454,355,355,280
2017-06-17,-12989,-15107,-15035,-16431,8043,5114,5114,3712,21032,20221,20149,20143,4,2,2,1,54,33,33,20,454,355,355,280
2017-06-25,-13229,-15347,-15275,-16671,8043,5114,5114,3712,21272,20461,20389,20383,4,2,2,1,54,33,33,20,454,355,355,280
2017-07-01,-13517,-15635,-15563,-16959,8043,5114,5114,3712,21560,20749,20677,20671,4,2,2,1,54,33,33,20,454,355,355,280
2017-07-06,-13787,-15875,-15803,-17199,8043,5114,5114,3712,21830,20989,20917,20911,4,2,2,1,54,33,33,20,464,363,363,288
2017-07-08,-14003,-16037,-15965,-17361,8043,5114,5114,3712,22046,21151,21079,21073,4,2,2,1,54,33,33,20,464,363,363,288
2017-07-09,-14273,-16307,-16235,-17631,8043,5114,5114,3712,22316,21421,21349,21343,4,2,2,1,54,33,33,20,469,368,368,293
2017-07-15,-14453,-16487,-16415,-17811,8043,5114,5114,3712,22496,21601,21529,21523,4,2,2,1,54,33,33,20,469,368,368,293
2017-07-22,-14741,-16775,-16703,-18099,8043,5114,5114,3712,22784,21889,21817,21811,4,2,2,1,54,33,33,20,469,368,368,293
2017-07-23,-15029,-17018,-16946,-18342,8043,5114,5114,3712,23072,22132,22060,22054,4,2,2,1,54,33,33,20,469,368,368,293
2017-07-25,-15299,-17288,-17216,-18612,8043,5114,5114,3712,23342,22402,22330,22324,4,2,2,1,54,33,33,20,469,368,368,293
2017-07-29,-15515,-17504,-17432,-18828,8043,5114,5114,3712,23558,22618,22546,22540,4,2,2,1,54,33,33,20,469,368,368,293
2017-08-05,-15803,-17570,-17498,-18894,8043,5318,5318,3916,23846,22888,22816,22810,4,2,2,1,54,33,33,20,469,371,371,296
2017-08-13,-16073,-17840,-17768,-19182,8043,5318,5318,3916,24116,23158,23086,23098,4,2,2,1,54,33,33,20,469,371,371,296
2017-08-16,-16361,-18128,-18056,-19470,8043,5318,5318,3916,24404,23446,23374,23386,4,2,2,1,54,33,33,20,469,371,371,296
2017-08-19,-16601,-18416,-18344,-19758,8043,5318,5318,3916,24644,23734,23662,23674,4,2,2,1,54,33,33,20,469,371,371,296
2017-08-23,-16841,-18656,-18584,-20046,8043,5318,5318,3916,24884,23974,23902,23962,4,2,2,1,54,33,33,20,477,379,379,302
2017-08-24,-17129,-18944,-18872,-20334,8043,5318,5318,3916,25172,24262,24190,24250,4,2,2,1,54,33,33,20,477,379,379,302
2017-08-25,-17429,-19244,-19172,-20634,8043,5318,5318,3916,25472,24562,24490,24550,4,2,2,1,54,33,33,20,477,379,379,302
2017-08-26,-17685,-19424,-19352,-20814,8043,5318,5318,3916,25728,24742,24670,24730,4,2,2,1,54,33,33,20,477,379,379,302
2017-08-27,-17877,-19712,-19640,-21102,8043,5318,5318,3916,25920,25030,24958,25018,4,2,2,1,54,33,33,20,477,379,379,302
2017-09-02,-18147,-19952,-19880,-21342,8043,5318,5318,3916,26190,25270,25198,25258,4,2,2,1,54,33,33,20,477,379,379,302
2017-09-03,-18435,-20240,-20168,-21630,8043,5318,5318,3916,26478,25558,25486,25546,4,2,2,1,54,33,33,20,483,385,385,308
2017-09-09,-18489,-20420,-20348,-21810,8205,5426,5426,4024,26694,25846,25774,25834,4,2,2,1,54,33,33,20,489,389,389,312
2017-09-10,-18759,-20690,-20618,-22080,8205,5426,5426,4024,26964,26116,26044,26104,4,2,2,1,54,33,33,20,489,389,389,312
2017-09-16,-18921,-20906,-20834,-22296,8205,5426,5426,4024,27126,26332,26260,26320,4,2,2,1,54,33,33,20,489,389,389,312
2017-09-23,-18880,-20348,-20276,-21738,8502,6227,6227,4825,27382,26575,26503,26563,4,2,2,1,55,36,36,23,502,422,422,345
2017-09-30,-19168,-20636,-20564,-22026,8502,6227,6227,4825,27670,26863,26791,26851,4,2,2,1,55,36,36,23,508,428,428,351
2017-10-01,-19456,-20852,-20780,-22242,8502,6227,6227,4825,27958,27079,27007,27067,4,2,2,1,55,36,36,23,508,428,428,351
2017-10-07,-19368,-20764,-20692,-22154,8806,6531,6531,5129,28174,27295,27223,27283,4,2,2,1,55,36,36,23,510,430,430,353
2017-10-14,-19584,-20980,-20908,-22334,8806,6531,6531,5129,28390,27511,27439,27463,4,2,2,1,55,36,36,23,514,434,434,357
2017-10-21,-19884,-21280,-21208,-22550,8806,6531,6531,5129,28690,27811,27739,27679,4,2,2,1,55,36,36,23,514,434,434,357
2017-10-28,-20164,-21560,-21488,-22760,8806,6531,6531,5129,28970,28091,28019,27889,4,2,2,1,55,36,36,23,514,434,434,357
2017-10-29,-20407,-21803,-21731,-22976,8806,6531,6531,5129,29213,28334,28262,28105,4,2,2,1,55,36,36,23,520,440,440,363
2017-11-04,-20587,-21878,-21806,-23051,8806,6696,6696,5294,29393,28574,28502,28345,4,2,2,1,55,36,36,23,520,443,443,366
2017-11-11,-20857,-22148,-22076,-23321,8806,6696,6696,5294,29663,28844,28772,28615,4,2,2,1,55,36,36,23,520,443,443,366
2017-11-12,-21100,-22391,-22319,-23564,8806,6696,6696,5294,29906,29087,29015,28858,4,2,2,1,55,36,36,23,520,443,443,366
2017-11-18,-21280,-22463,-22391,-23636,8914,6912,6912,5510,30194,29375,29303,29146,4,2,2,1,55,36,36,23,522,447,447,370
2017-11-25,-21496,-22679,-22607,-23852,8914,6912,6912,5510,30410,29591,29519,29362,4,2,2,1,55,36,36,23,522,447,447,370
2017-11-26,-21784,-22967,-22895,-24140,8914,6912,6912,5510,30698,29879,29807,29650,4,2,2,1,55,36,36,23,525,450,450,373
2017-12-02,-21946,-23255,-23183,-24428,9040,6912,6912,5510,30986,30167,30095,29938,4,2,2,1,55,36,36,23,531,450,450,373
2017-12-09,-22186,-23495,-23423,-24668,9040,6912,6912,5510,31226,30407,30335,30178,4,2,2,1,55,36,36,23,531,450,450,373
2017-12-16,-22327,-23606,-23534,-24779,9142,6963,6963,5561,31469,30569,30497,30340,4,2,2,1,55,36,36,23,537,453,453,376
2017-12-23,-22543,-23822,-23822,-24941,9142,6963,6963,5561,31685,30785,30785,30502,4,2,2,1,55,36,36,23,537,453,453,376
2017-12-25,-22783,-24078,-24078,-25197,9142,6963,6963,5561,31925,31041,31041,30758,4,2,2,1,55,36,36,23,537,453,453,376
2017-12-26,-23071,-24366,-24366,-25485,9142,6963,6963,5561,32213,31329,31329,31046,4,2,2,1,55,36,36,23,537,453,453,376
2017-12-27,-23311,-24558,-24558,-25677,9142,6963,6963,5561,32453,31521,31521,31238,4,2,2,1,55,36,36,23,543,459,459,382
2017-12-28,-23581,-24773,-24773,-25892,9142,6988,6988,5586,32723,31761,31761,31478,4,2,2,1,55,37,37,24,544,471,471,394
2017-12-29,-23824,-25016,-25016,-26108,9142,6988,6988,5586,32966,32004,32004,31694,4,2,2,1,55,37,37,24,544,471,471,394
2017-12-30,-24067,-25259,-25259,-26351,9142,6988,6988,5586,33209,32247,32247,31937,4,2,2,1,55,37,37,24,544,471,471,394
2017-12-31,-24323,-25547,-25547,-26639,9142,6988,6988,5586,33465,32535,32535,32225,4,2,2,1,55,37,37,24,544,471,471,394
2018-01-06,-24593,-25817,-25817,-26927,9142,6988,6988,5586,33735,32805,32805,32513,4,2,2,1,55,37,37,24,544,471,471,394
2018-01-13,-24692,-25916,-25916,-27215,9331,7177,7177,5586,34023,33093,33093,32801,4,2,2,1,58,40,40,24,580,507,507,397
2018-01-20,-24842,-26160,-26160,-27459,9397,7221,7221,5630,34239,33381,33381,33089,4,2,2,1,61,42,42,26,613,529,529,419
2018-01-27,-21418,-22736,-22736,-24037,13109,10933,10933,9268,34527,33669,33669,33305,5,3,3,2,74,55,55,37,680,596,596,468
2018-01-28,-21634,-22952,-22952,-24253,13109,10933,10933,9268,34743,33885,33885,33521,5,3,3,2,74,55,55,37,682,600,600,472
2018-02-03,-21934,-23252,-23252,-24553,13109,10933,10933,9268,35043,34185,34185,33821,5,3,3,2,74,55,55,37,698,616,616,488
2018-02-10,-22018,-23492,-23492,-24793,13295,10933,10933,9268,35313,34425,34425,34061,5,3,3,2,77,55,55,37,737,620,620,492
2018-02-17,-22054,-23528,-23528,-25009,13547,11185,11185,9268,35601,34713,34713,34277,5,3,3,2,77,55,55,37,743,626,626,492
2018-02-24,-22342,-23690,-23690,-25171,13547,11185,11185,9268,35889,34875,34875,34439,5,3,3,2,77,55,55,37,743,626,626,492
2018-02-25,-22582,-23870,-23870,-25351,13547,11185,11185,9268,36129,35055,35055,34619,5,3,3,2,77,55,55,37,743,626,626,492
2018-03-03,-22882,-24170,-24170,-25651,13547,11185,11185,9268,36429,35355,35355,34919,5,3,3,2,77,55,55,37,743,626,626,492
2018-03-10,-22837,-24125,-24440,-25579,13835,11473,11185,9556,36672,35598,35625,35135,5,3,3,2,80,58,55,40,776,659,629,522
2018-03-17,-23077,-24413,-24728,-25867,13835,11473,11185,9556,36912,35886,35913,35423,5,3,3,2,80,58,55,40,776,671,641,534
2018-03-24,-23333,-24565,-24880,-26019,13879,11561,11273,9644,37212,36126,36153,35663,5,3,3,2,80,58,55,40,778,675,645,538
2018-03-29,-23603,-24835,-25096,-26289,13879,11561,11273,9644,37482,36396,36369,35933,5,3,3,2,83,61,58,43,817,714,690,577
2018-03-30,-21853,-23085,-23346,-26321,15917,13599,13311,9828,37770,36684,36657,36149,5,3,3,2,85,63,60,43,841,738,714,581
2018-03-31,-22093,-23325,-23586,-26561,15917,13599,13311,9828,38010,36924,36897,36389,5,3,3,2,85,63,60,43,841,738,714,581
2018-04-01,-22240,-23472,-23805,-26708,15986,13668,13380,9897,38226,37140,37185,36605,5,3,3,2,88,66,63,46,877,774,753,617
2018-04-07,-22492,-23670,-24003,-26906,16022,13686,13398,9915,38514,37356,37401,36821,5,3,3,2,90,67,64,47,901,785,764,628
2018-04-14,-22780,-23958,-24291,-27194,16022,13686,13398,9915,38802,37644,37689,37109,5,3,3,2,90,67,64,47,901,785,764,628
2018-04-21,-23050,-24228,-24561,-27410,16022,13686,13398,9915,39072,37914,37959,37325,5,3,3,2,90,67,64,47,901,785,764,628
2018-04-28,-23206,-24384,-24717,-27566,16136,13800,13512,10029,39342,38184,38229,37595,5,3,3,2,90,67,64,47,907,791,770,634
2018-05-01,-23422,-24627,-24960,-27809,16136,13800,13512,10029,39558,38427,38472,37838,5,3,3,2,90,67,64,47,907,791,770,634
2018-05-05,-23710,-24915,-25248,-28097,16136,13800,13512,10029,39846,38715,38760,38126,5,3,3,2,90,67,64,47,907,791,770,634
2018-05-06,-23936,-25159,-25492,-28341,16180,13844,13556,10073,40116,39003,39048,38414,5,3,3,2,92,69,66,49,931,813,792,656
2018-05-12,-24142,-25365,-25698,-28547,16244,13908,13620,10137,40386,39273,39318,38684,5,3,3,2,92,69,66,49,935,817,796,660
2018-05-13,-24342,-25605,-25938,-28787,16244,13908,13620,10137,40586,39513,39558,38924,5,3,3,2,92,69,66,49,935,817,796,660
2018-05-19,-24582,-25845,-26178,-29027,16244,13908,13620,10137,40826,39753,39798,39164,5,3,3,2,92,69,66,49,935,817,796,660
2018-05-26,-24806,-26007,-26340,-29189,16308,13908,13620,10137,41114,39915,39960,39326,5,3,3,2,92,69,66,49,937,817,796,660
2018-05-27,-18875,-20076,-20409,-23258,22527,20127,19839,16356,41402,40203,40248,39614,6,4,4,3,104,81,78,61,998,878,857,721
2018-06-02,-19163,-20364,-20697,-23546,22527,20127,19839,16356,41690,40491,40536,39902,6,4,4,3,104,81,78,61,998,878,857,721
2018-06-09,-19451,-20604,-20937,-23786,22527,20127,19839,16356,41978,40731,40776,40142,6,4,4,3,104,81,78,61,998,878,857,721
2018-06-10,-19679,-20832,-21165,-24014,22599,20199,19911,16428,42278,41031,41076,40442,6,4,4,3,107,84,81,64,1040,920,899,763
2018-06-16,-19949,-21102,-21435,-24284,22599,20199,19911,16428,42548,41301,41346,40712,6,4,4,3,107,84,81,64,1040,920,899,763
2018-06-24,-20121,-21274,-21607,-24500,22667,20267,19979,16428,42788,41541,41586,40928,6,4,4,3,107,84,81,64,1044,924,903,763
2018-06-30,-20199,-21352,-21685,-24578,22805,20405,20117,16566,43004,41757,41802,41144,6,4,4,3,107,84,81,64,1046,926,905,765
2018-07-05,-20415,-21568,-21901,-24826,22805,20405,20117,16606,43220,41973,42018,41432,6,4,4,3,107,84,81,66,1049,929,908,787
2018-07-07,-20658,-21730,-22063,-24988,22805,20405,20117,16606,43463,42135,42180,41594,6,4,4,3,107,84,81,66,1049,929,908,787
2018-07-08,-20796,-21868,-22201,-25090,22883,20483,20195,16684,43679,42351,42396,41774,6,4,4,3,109,86,83,68,1073,953,932,809
2018-07-14,-21036,-22048,-22381,-25270,22883,20483,20195,16684,43919,42531,42576,41954,6,4,4,3,109,86,83,68,1073,953,932,809
2018-07-21,-21306,-22288,-22621,-25510,22883,20483,20195,16684,44189,42771,42816,42194,6,4,4,3,109,86,83,68,1073,953,932,809
2018-07-22,-21522,-22504,-22837,-25798,22883,20483,20195,16684,44405,42987,43032,42482,6,4,4,3,109,86,83,68,1073,953,932,809
2018-07-28,-21738,-22684,-23017,-25978,22937,20591,20303,16792,44675,43275,43320,42770,6,4,4,3,109,86,83,68,1076,959,938,815
2018-07-31,-22026,-22927,-23260,-26221,22937,20591,20303,16792,44963,43518,43563,43013,6,4,4,3,109,86,83,68,1076,959,938,815
2018-08-04,-22314,-23215,-23548,-26509,22937,20591,20303,16792,45251,43806,43851,43301,6,4,4,3,109,86,83,68,1076,959,938,815
2018-08-11,-22506,-23407,-23740,-26797,22937,20591,20303,16792,45443,43998,44043,43589,6,4,4,3,109,86,83,68,1076,959,938,815
2018-08-12,-22794,-23695,-24028,-27085,22937,20591,20303,16792,45731,44286,44331,43877,6,4,4,3,109,86,83,68,1080,963,942,819
2018-08-14,-23094,-23995,-24328,-27385,22937,20591,20303,16792,46031,44586,44631,44177,6,4,4,3,109,86,83,68,1080,963,942,819
2018-08-18,-23310,-24211,-24544,-27601,22937,20591,20303,16792,46247,44802,44847,44393,6,4,4,3,109,86,83,68,1080,963,942,819
2018-08-22,-23526,-24427,-24760,-27889,22937,20591,20303,16792,46463,45018,45063,44681,6,4,4,3,109,86,83,68,1080,963,942,819
2018-08-23,-23814,-24715,-25048,-28081,22937,20591,20303,16792,46751,45306,45351,44873,6,4,4,3,109,86,83,68,1080,963,942,819
2018-08-24,-24039,-24940,-24492,-28324,22982,20636,21084,16837,47021,45576,45576,45161,6,4,5,3,112,89,96,71,1116,999,1006,852
2018-08-25,-24127,-25028,-24129,-28508,23086,20740,21717,16941,47213,45768,45846,45449,6,4,5,3,112,89,97,71,1120,1003,1020,856
2018-08-26,-24322,-25190,-24291,-28670,23134,20740,21717,16941,47456,45930,46008,45611,6,4,5,3,115,89,97,71,1153,1006,1023,859
2018-09-01,-24562,-25478,-24579,-28958,23134,20740,21717,16941,47696,46218,46296,45899,6,4,5,3,115,89,97,71,1153,1006,1023,859
2018-09-02,-24762,-25718,-24819,-29198,23217,20740,21717,16941,47979,46458,46536,46139,6,4,5,3,116,89,97,71,1167,1008,1025,861
2018-09-08,-24840,-25796,-24897,-29276,23382,20905,21882,17106,48222,46701,46779,46382,6,4,5,3,116,89,97,71,1170,1011,1028,864
2018-09-09,-24884,-26084,-25185,-29564,23578,20905,21882,17106,48462,46989,47067,46670,6,4,5,3,116,89,97,71,1172,1011,1028,864
2018-09-15,-24992,-26372,-25473,-29852,23758,20905,21882,17106,48750,47277,47355,46958,6,4,5,3,119,89,97,71,1208,1014,1031,867
2018-09-16,-25262,-26642,-25743,-30122,23758,20905,21882,17106,49020,47547,47625,47228,6,4,5,3,119,89,97,71,1208,1014,1031,867
2018-09-22,-25184,-26564,-25665,-30044,24106,21253,22230,17454,49290,47817,47895,47498,6,4,5,3,122,92,100,74,1247,1053,1070,903
2018-09-29,-25343,-26723,-25824,-30260,24217,21364,22341,17454,49560,48087,48165,47714,6,4,5,3,125,95,103,74,1283,1089,1106,912
2018-09-30,-25605,-26985,-26086,-30522,24217,21364,22341,17454,49822,48349,48427,47976,6,4,5,3,125,95,103,74,1283,1089,1106,912
2018-10-06,-25885,-27265,-26366,-30802,24237,21384,22361,17474,50122,48649,48727,48276,6,4,5,3,126,96,104,75,1297,1103,1120,926
2018-10-13,-26173,-27553,-26654,-31090,24237,21384,22361,17474,50410,48937,49015,48564,6,4,5,3,126,96,104,75,1303,1103,1120,926
2018-10-20,-25943,-27323,-26424,-30860,24707,21854,22831,17944,50650,49177,49255,48804,6,4,5,3,126,96,104,75,1313,1113,1130,936
2018-10-27,-26159,-27539,-26640,-30915,24707,21854,22831,18177,50866,49393,49471,49092,6,4,5,4,127,97,105,88,1324,1124,1141,1000
2018-10-28,-26447,-27827,-26928,-31203,24707,21854,22831,18177,51154,49681,49759,49380,6,4,5,4,130,99,107,90,1360,1146,1163,1022
2018-11-03,-26735,-28067,-27168,-31443,24707,21854,22831,18177,51442,49921,49999,49620,6,4,5,4,130,99,107,90,1360,1146,1163,1022
2018-11-10,-27018,-28256,-27357,-31632,24707,21854,22831,18177,51725,50110,50188,49809,6,4,5,4,130,99,107,90,1360,1146,1163,1022
2018-11-11,-27306,-28544,-27645,-31920,24707,21854,22831,18177,52013,50398,50476,50097,6,4,5,4,130,99,107,90,1360,1146,1163,1022
2018-11-17,-27594,-28832,-27933,-32208,24707,21854,22831,18177,52301,50686,50764,50385,6,4,5,4,130,99,107,90,1360,1146,1163,1022
2018-11-24,-27754,-29120,-28221,-32496,24707,21854,22831,18177,52461,50974,51052,50673,6,4,5,4,130,99,107,90,1360,1146,1163,1022
2018-11-25,-27619,-28985,-28086,-32433,25058,22205,23182,18528,52677,51190,51268,50961,7,5,6,5,141,110,118,101,1409,1195,1212,1074
2018-12-01,-27611,-29053,-28154,-32501,25354,22353,23330,18676,52965,51406,51484,51177,7,5,6,5,145,112,120,103,1457,1215,1232,1094
2018-12-08,-27620,-29062,-28145,-32789,25633,22632,23609,18676,53253,51694,51754,51465,7,5,6,5,148,115,123,103,1493,1251,1271,1100
2018-12-15,-27908,-29350,-28433,-33005,25633,22632,23609,18676,53541,51982,52042,51681,7,5,6,5,148,115,123,103,1499,1257,1277,1106
2018-12-22,-28151,-29566,-28649,-33221,25633,22632,23609,18676,53784,52198,52258,51897,7,5,6,5,148,115,123,103,1499,1257,1277,1106
2018-12-23,-28421,-29836,-28919,-33491,25633,22632,23609,18676,54054,52468,52528,52167,7,5,6,5,148,115,123,103,1499,1257,1277,1106
2018-12-25,-28637,-30052,-29135,-33707,25633,22632,23609,18676,54270,52684,52744,52383,7,5,6,5,148,115,123,103,1499,1257,1277,1106
2018-12-26,-28925,-30340,-29423,-33995,25633,22632,23609,18676,54558,52972,53032,52671,7,5,6,5,148,115,123,103,1499,1257,1277,1106
2018-12-27,-29117,-30556,-29639,-34211,25633,22632,23609,18676,54750,53188,53248,52887,7,5,6,5,148,115,123,103,1499,1257,1277,1106
2018-12-28,-29213,-30652,-29735,-34307,25825,22824,23801,18868,55038,53476,53536,53175,7,5,6,5,148,115,123,103,1511,1269,1289,1118
2018-12-29,-29453,-30892,-29975,-34323,25825,22824,23801,19108,55278,53716,53776,53431,7,5,6,5,148,115,123,103,1511,1269,1289,1122
2018-12-30,-29087,-30526,-29609,-33957,26353,23352,24329,19636,55440,53878,53938,53593,7,5,6,5,148,115,123,103,1523,1281,1301,1134
2018-12-31,-29303,-30814,-29897,-34245,26353,23352,24329,19636,55656,54166,54226,53881,7,5,6,5,148,115,123,103,1523,1281,1301,1134
2019-01-05,-29559,-31102,-30185,-34533,26353,23352,24329,19636,55912,54454,54514,54169,7,5,6,5,148,115,123,103,1523,1281,1301,1134
2019-01-12,-29824,-31367,-30450,-34702,26376,23375,24352,19659,56200,54742,54802,54361,7,5,6,5,148,115,123,103,1524,1282,1302,1135
2019-01-19,-30094,-31637,-30720,-34972,26376,23375,24352,19659,56470,55012,55072,54631,7,5,6,5,148,115,123,103,1524,1282,1302,1135
2019-01-26,-30310,-31853,-30936,-35188,26376,23375,24352,19659,56686,55228,55288,54847,7,5,6,5,148,115,123,103,1524,1282,1302,1135
2019-01-27,-30502,-32141,-31224,-35476,26376,23375,24352,19659,56878,55516,55576,55135,7,5,6,5,148,115,123,103,1524,1282,1302,1135
2019-02-02,-30790,-32357,-31440,-35692,26376,23375,24352,19659,57166,55732,55792,55351,7,5,6,5,148,115,123,103,1524,1282,1302,1135
2019-02-09,-31006,-32600,-31683,-35935,26376,23375,24352,19659,57382,55975,56035,55594,7,5,6,5,148,115,123,103,1524,1282,1302,1135
2019-02-16,-31222,-32816,-31899,-36151,26376,23375,24352,19659,57598,56191,56251,55810,7,5,6,5,148,115,123,103,1524,1282,1302,1135
2019-02-23,-31510,-33104,-32187,-36439,26376,23375,24352,19659,57886,56479,56539,56098,7,5,6,5,148,115,123,103,1524,1282,1302,1135
2019-03-02,-31190,-33404,-32487,-36739,26996,23375,24352,19659,58186,56779,56839,56398,7,5,6,5,148,115,123,103,1534,1282,1302,1135
2019-03-03,-31478,-33508,-32591,-36843,26996,23559,24536,19843,58474,57067,57127,56686,7,5,6,5,148,115,123,103,1534,1290,1310,1143
2019-03-09,-31718,-33748,-32831,-37059,26996,23559,24536,19843,58714,57307,57367,56902,7,5,6,5,148,115,123,103,1538,1294,1314,1145
2019-03-16,-32018,-33988,-33071,-37299,26996,23559,24536,19843,59014,57547,57607,57142,7,5,6,5,148,115,123,103,1538,1294,1314,1145
2019-03-23,-32261,-34093,-33176,-37404,26996,23697,24674,19981,59257,57790,57850,57385,7,5,6,5,148,115,123,103,1538,1300,1320,1151
2019-03-30,-32504,-34309,-33392,-37620,26996,23697,24674,19981,59500,58006,58066,57601,7,5,6,5,148,115,123,103,1538,1300,1320,1151
2019-03-31,-32774,-34579,-33662,-37908,26996,23697,24674,19981,59770,58276,58336,57889,7,5,6,5,148,115,123,103,1538,1300,1320,1151
2019-04-06,-33014,-34819,-33902,-38148,26996,23697,24674,19981,60010,58516,58576,58129,7,5,6,5,148,115,123,103,1538,1300,1320,1151
2019-04-13,-33284,-34999,-34082,-38328,26996,23697,24674,19981,60280,58696,58756,58309,7,5,6,5,148,115,123,103,1538,1300,1320,1151
2019-04-18,-33527,-35242,-34325,-38490,26996,23697,24674,19981,60523,58939,58999,58471,7,5,6,5,151,118,126,103,1571,1333,1353,1154
2019-04-19,-33674,-35512,-34595,-38760,27092,23697,24674,19981,60766,59209,59269,58741,7,5,6,5,151,118,126,103,1574,1333,1353,1154
2019-04-20,-33926,-35728,-34811,-38976,27092,23697,24674,19981,61018,59425,59485,58957,7,5,6,5,151,118,126,103,1574,1333,1353,1154
2019-04-21,-34100,-35902,-34985,-39150,27174,23779,24756,20063,61274,59681,59741,59213,7,5,6,5,151,118,126,103,1576,1335,1355,1156
2019-04-27,-34370,-36118,-35201,-39366,27174,23779,24756,20063,61544,59897,59957,59429,7,5,6,5,151,118,126,103,1576,1335,1355,1156
2019-05-01,-34658,-36406,-35457,-39654,27174,23779,24756,20063,61832,60185,60213,59717,7,5,6,5,151,118,126,103,1580,1339,1355,1160
2019-05-04,-34784,-36694,-35745,-39942,27318,23779,24756,20063,62102,60473,60501,60005,7,5,6,5,153,118,126,103,1604,1343,1359,1164
2019-05-11,-35027,-36937,-35988,-40104,27318,23779,24756,20063,62345,60716,60744,60167,7,5,6,5,153,118,126,103,1604,1343,1359,1164
2019-05-12,-35267,-37193,-36244,-40360,27318,23779,24756,20063,62585,60972,61000,60423,7,5,6,5,153,118,126,103,1604,1343,1359,1164
2019-05-18,-35555,-37385,-36436,-40552,27318,23779,24756,20063,62873,61164,61192,60615,7,5,6,5,153,118,126,103,1604,1343,1359,1164
2019-05-25,-35825,-37655,-36706,-40822,27318,23779,24756,20063,63143,61434,61462,60885,7,5,6,5,153,118,126,103,1604,1343,1359,1164
2019-05-26,-36068,-37898,-36949,-41065,27318,23779,24756,20063,63386,61677,61705,61128,7,5,6,5,153,118,126,103,1604,1343,1359,1164
2019-06-01,-36308,-38114,-37165,-41281,27318,23779,24756,20063,63626,61893,61921,61344,7,5,6,5,153,118,126,103,1604,1343,1359,1164
2019-06-08,-36596,-38402,-37453,-41569,27318,23779,24756,20063,63914,62181,62209,61632,7,5,6,5,153,118,126,103,1604,1343,1359,1164
2019-06-09,-36542,-38348,-37399,-41515,27588,24049,25026,20333,64130,62397,62425,61848,7,5,6,5,153,118,126,103,1610,1349,1365,1170
2019-06-15,-36731,-38528,-37579,-41695,27669,24157,25134,20441,64400,62685,62713,62136,7,5,6,5,153,118,126,103,1613,1353,1369,1174
2019-06-23,-36971,-38720,-37771,-41887,27669,24157,25134,20441,64640,62877,62905,62328,7,5,6,5,153,118,126,103,1613,1353,1369,1174
2019-06-29,-37157,-38990,-38041,-42157,27753,24157,25134,20441,64910,63147,63175,62598,7,5,6,5,156,118,126,103,1652,1356,1372,1177
2019-07-04,-37445,-39278,-38329,-42445,27753,24157,25134,20441,65198,63435,63463,62886,7,5,6,5,156,118,126,103,1652,1356,1372,1177
2019-07-06,-37715,-39548,-38599,-42733,27753,24157,25134,20441,65468,63705,63733,63174,7,5,6,5,156,118,126,103,1652,1356,1372,1177
2019-07-07,-37934,-39695,-38746,-42880,27822,24226,25203,20510,65756,63921,63949,63390,7,5,6,5,156,118,126,103,1655,1359,1375,1180
2019-07-13,-38174,-39935,-38986,-43120,27822,24226,25203,20510,65996,64161,64189,63630,7,5,6,5,156,118,126,103,1655,1359,1375,1180
2019-07-20,-38417,-40178,-39229,-43363,27822,24226,25203,20510,66239,64404,64432,63873,7,5,6,5,156,118,126,103,1655,1359,1375,1180
2019-07-21,-38633,-40394,-39445,-43579,27822,24226,25203,20510,66455,64620,64648,64089,7,5,6,5,156,118,126,103,1655,1359,1375,1180
2019-07-27,-38777,-40538,-39589,-43723,27840,24244,25221,20528,66617,64782,64810,64251,7,5,6,5,157,119,127,104,1666,1370,1386,1191
2019-07-30,-38783,-40778,-39829,-43963,28074,24244,25221,20528,66857,65022,65050,64491,7,5,6,5,159,119,127,104,1690,1374,1390,1195
2019-08-03,-39023,-41066,-40117,-44251,28074,24244,25221,20528,67097,65310,65338,64779,7,5,6,5,159,119,127,104,1705,1386,1402,1207
2019-08-10,-39223,-41266,-40317,-44551,28074,24244,25221,20528,67297,65510,65538,65079,7,5,6,5,159,119,127,104,1707,1388,1404,1209
2019-08-11,-39439,-41482,-40533,-44767,28074,24244,25221,20528,67513,65726,65754,65295,7,5,6,5,159,119,127,104,1707,1388,1404,1209
2019-08-14,-39655,-41770,-40821,-45055,28074,24244,25221,20528,67729,66014,66042,65583,7,5,6,5,159,119,127,104,1710,1390,1406,1211
2019-08-17,-39841,-41986,-41037,-45271,28176,24244,25221,20528,68017,66230,66258,65799,7,5,6,5,162,119,127,104,1746,1396,1412,1217
2019-08-21,-40129,-42274,-41325,-45559,28176,24244,25221,20528,68305,66518,66546,66087,7,5,6,5,162,119,127,104,1746,1396,1412,1217
2019-08-22,-40193,-42338,-41389,-45623,28328,24396,25373,20680,68521,66734,66762,66303,7,5,6,5,162,119,127,104,1748,1398,1414,1219
2019-08-23,-40463,-42608,-41659,-45893,28328,24396,25373,20680,68791,67004,67032,66573,7,5,6,5,162,119,127,104,1748,1398,1414,1219
2019-08-24,-40733,-42878,-41929,-46163,28328,24396,25373,20680,69061,67274,67302,66843,7,5,6,5,162,119,127,104,1748,1398,1414,1219
2019-08-25,-40823,-42968,-42019,-46253,28454,24522,25499,20806,69277,67490,67518,67059,7,5,6,5,165,122,130,107,1781,1431,1447,1249
2019-08-31,-40979,-43208,-42259,-46493,28538,24522,25499,20806,69517,67730,67758,67299,7,5,6,5,165,122,130,107,1785,1431,1447,1249
2019-09-01,-41249,-43478,-42529,-46763,28538,24522,25499,20806,69787,68000,68028,67569,7,5,6,5,165,122,130,107,1785,1431,1447,1249
2019-09-07,-41492,-43721,-42772,-47006,28538,24522,25499,20806,70030,68243,68271,67812,7,5,6,5,165,122,130,107,1785,1431,1447,1249
2019-09-08,-41708,-43937,-42988,-47222,28538,24522,25499,20806,70246,68459,68487,68028,7,5,6,5,165,122,130,107,1785,1431,1447,1249
2019-09-14,-41996,-44225,-43276,-47510,28538,24522,25499,20806,70534,68747,68775,68316,7,5,6,5,165,122,130,107,1785,1431,1447,1249
2019-09-21,-42284,-44513,-43564,-47798,28538,24522,25499,20806,70822,69035,69063,68604,7,5,6,5,165,122,130,107,1785,1431,1447,1249
2019-09-28,-42554,-44783,-43834,-48068,28538,24522,25499,20806,71092,69305,69333,68874,7,5,6,5,165,122,130,107,1785,1431,1447,1249
2019-09-29,-42824,-45071,-44122,-48356,28538,24522,25499,20806,71362,69593,69621,69162,7,5,6,5,165,122,130,107,1785,1431,1447,1249
2019-10-05,-43056,-45303,-44354,-48572,28594,24578,25555,20806,71650,69881,69909,69378,7,5,6,5,165,122,130,107,1787,1433,1449,1249
2019-10-12,-43272,-45519,-44570,-48788,28594,24578,25555,20806,71866,70097,70125,69594,7,5,6,5,165,122,130,107,1787,1433,1449,1249
2019-10-19,-43456,-45675,-44726,-48944,28666,24614,25591,20842,72122,70289,70317,69786,7,5,6,5,167,123,131,108,1811,1444,1460,1260
2019-10-26,-43460,-45679,-44798,-48948,28864,24812,25789,21040,72324,70491,70587,69988,7,5,6,5,167,123,131,108,1814,1447,1463,1263
2019-10-27,-43730,-45949,-45068,-49218,28864,24812,25789,21040,72594,70761,70857,70258,7,5,6,5,170,126,134,111,1850,1483,1499,1299
2019-11-02,-43946,-46165,-45284,-49434,28864,24812,25789,21040,72810,70977,71073,70474,7,5,6,5,170,126,134,111,1850,1483,1499,1299
2019-11-09,-44072,-46309,-45428,-49578,29008,24908,25885,21136,73080,71217,71313,70714,7,5,6,5,170,126,134,111,1856,1487,1503,1303
2019-11-10,-44360,-46597,-45716,-49866,29008,24908,25885,21136,73368,71505,71601,71002,7,5,6,5,170,126,134,111,1856,1487,1503,1303
2019-11-16,-44648,-46885,-46004,-50154,29008,24908,25885,21136,73656,71793,71889,71290,7,5,6,5,170,126,134,111,1860,1491,1507,1307
2019-11-23,-44936,-47101,-46220,-50370,29008,24908,25885,21136,73944,72009,72105,71506,7,5,6,5,170,126,134,111,1860,1491,1507,1307
2019-11-30,-45152,-47389,-46508,-50658,29008,24908,25885,21136,74160,72297,72393,71794,7,5,6,5,170,126,134,111,1860,1491,1507,1307
2019-12-01,-45440,-47677,-46796,-50946,29008,24908,25885,21136,74448,72585,72681,72082,7,5,6,5,170,126,134,111,1860,1491,1507,1307
2019-12-07,-45666,-47841,-46960,-51110,29070,25032,26009,21260,74736,72873,72969,72370,7,5,6,5,170,126,134,111,1862,1495,1511,1311
2019-12-14,-45954,-48057,-47176,-51326,29070,25032,26009,21260,75024,73089,73185,72586,7,5,6,5,170,126,134,111,1862,1495,1511,1311
2019-12-21,-45854,-48049,-47168,-51318,29440,25328,26305,21556,75294,73377,73473,72874,7,5,6,5,170,126,134,111,1872,1503,1519,1319
2019-12-23,-46124,-48265,-47384,-51534,29440,25328,26305,21556,75564,73593,73689,73090,7,5,6,5,170,126,134,111,1872,1503,1519,1319
2019-12-25,-46412,-48553,-47672,-51822,29440,25328,26305,21556,75852,73881,73977,73378,7,5,6,5,170,126,134,111,1872,1503,1519,1319
2019-12-26,-46592,-48757,-47876,-52026,29440,25380,26357,21608,76032,74137,74233,73634,7,5,6,5,170,127,135,112,1873,1515,1531,1331
2019-12-27,-46835,-48973,-48092,-52242,29440,25380,26357,21608,76275,74353,74449,73850,7,5,6,5,170,127,135,112,1873,1515,1531,1331
2019-12-28,-47123,-49261,-48380,-52530,29440,25380,26357,21608,76563,74641,74737,74138,7,5,6,5,170,127,135,112,1873,1515,1531,1331
2019-12-29,-47339,-49477,-48650,-52746,29440,25380,26357,21608,76779,74857,75007,74354,7,5,6,5,170,127,135,112,1873,1515,1531,1331
